namespace
#l;kajsdf
lksjdf

/az/%C5%9F%C9%99xsi/owner-info/offers  /az/l/Offers/  *
/de/konnektivitaet  /de/v/connectivity/infotainment-page  *
/ca/  /language-selector/americas/canada	*
/jp/1year-smavo	/jp/cp/xc60-1year-smavocp	*
/jp/2daysmonitor	/jp/cp/2days-monitor	*
/nl/360c	/nl/v/cars/concept-models/360c  *
/nl-be/xc40  /nl/v/cars/xc40-hybrid  *
/nl/xc40e  /nl/v/cars/xc40-electric  *
/nl/xc90  /nl/v/cars/xc90-hybrid  *a
/nl/s60  /nl/v/cars/s60-hybrid  *
/nl/s90  /nl/v/cars/s90-hybrid  *
/nl/v60  /nl/v/cars/v60-hybrid  *
/nl/v90  /nl/v/cars/v90-hybrid  *
/uk/360c	/uk/About/HumanMade/Concept-Cars/360c	*
/fr-be/A-propos-de-Volvo/Innovations/Drive-E	/fr-be/pourquoi-volvo/innovation-humaine/avenir-de-la-conduite	*
/fr-be/A-propos-de-Volvo/Innovations/Drive-E/CNG	/fr-be/pourquoi-volvo/innovation-humaine/avenir-de-la-conduite	*
/fr-be/A-propos-de-Volvo/Innovations/Drive-E/Electrification	/fr-be/pourquoi-volvo/innovation-humaine/avenir-de-la-conduite	*
/fr-be/A-propos-de-Volvo/Innovations/Drive-E/Twin-Engine	/fr-be/pourquoi-volvo/innovation-humaine/avenir-de-la-conduite	*
/fr-be/A-propos-de-Volvo/Innovations/Drive-E/Volvo-hybride	/fr-be/pourquoi-volvo/innovation-humaine/avenir-de-la-conduite	*
/fr-be/A-propos-de-Volvo/Innovations/IntelliSafe	/fr-be/pourquoi-volvo/innovation-humaine/avenir-de-la-conduite	*
/fr-be/A-propos-de-Volvo/Innovations/IntelliSafe/Autopilot	/fr-be/pourquoi-volvo/innovation-humaine/avenir-de-la-conduite	*
/fr-be/A-propos-de-Volvo/Innovations/IntelliSafe/Autopilot/C26	/fr-be/pourquoi-volvo/innovation-humaine/avenir-de-la-conduite	*
/fr-be/A-propos-de-Volvo/Innovations/Sensus	/fr-be/pourquoi-volvo/innovation-humaine/avenir-de-la-conduite	*
/fr-be/A-propos-de-Volvo/Innovations/Sensus/Send-to-Car	/fr-be/pourquoi-volvo/innovation-humaine/avenir-de-la-conduite	*
/fr-be/A-propos-de-Volvo/Innovations/Sensus/Sensus-Connect	/fr-be/pourquoi-volvo/innovation-humaine/avenir-de-la-conduite	*
/fr/Achat/Construire-votre-projet/Accessoires/Sieges-enfant/Les-sieges-enfant	/fr/Achat/Construire-votre-projet/Accessoires/Les-sieges-enfant	*
/intl/Al	/intl/why-volvo/human-innovation/future-of-driving	*
/de-ch/All-Cars-MY08/Volvo-C30	/de-ch/modelle/showroom	*
/de/All-Cars-MY08/Volvo-V70-new	/de/Deutschland	*
/it/All-Cars-MY09/Volvo-C30	/it/modelli/esplora-i-modelli	*
/it/All-Cars-MY09/Volvo-C70	/it/modelli/esplora-i-modelli	*
/it/All-Cars-MY09/Volvo-S40	/it/modelli/esplora-i-modelli	*
/it/All-Cars-MY09/Volvo-S60	/it/modelli/volvo/s60	*
/it/All-Cars-MY09/Volvo-S80	/it/modelli/volvo/s80	*
/it/All-Cars-MY09/Volvo-V70-New	/it/modelli/volvo/v70	*
/it/All-Cars-MY09/Volvo-XC60	/it/modelli/volvo/xc60	*
/it/All-Cars-MY09/Volvo-XC70	/it/modelli/volvo/xc70	*
/it/All-Cars-MY09/Volvo-XC90	/it/modelli/volvo/nuova-xc90	*
/de/Ausstattungspraemie	/de/modelle/neuwagen/xc60/ausstattungspraemie	*
/nl/Brochure-VCF	/nl/ontdek/producten/finance	*
/nl/Brochure-VCL	/nl/ontdek/producten/lease/informatie-en-documentatie	*
/uk/Brownlee-Brothers	/uk/About/HumanMade/Discover-Volvo/Brownlee-Brothers	*
/fr/C30	/fr/gamme/modeles/v40	*
/fr/C70	/fr/gamme/tous-les-modeles	*
/uk/COVID	/uk/COVID-19-Update	*
/uk/COVID-19	/uk/COVID-19-Update	*
/uk/COVID19	/uk/COVID-19-Update	*
/br/Carros/Novos-Modelos/s60	/br/modelos-volvo/novos-modelos/s60	*
/br/Carros/Novos-Modelos/s60/Edicoes	/br/modelos-volvo/novos-modelos/s60/versoes	*
/br/Carros/Novos-Modelos/s60/Especificacoes	/br/modelos-volvo/novos-modelos/s60	*
/br/Carros/Novos-Modelos/s60/Galeria	/br/modelos-volvo/novos-modelos/s60	*
/br/Carros/Novos-Modelos/xc60	/br/modelos-volvo/novos-modelos/xc60	*
/br/Carros/Novos-Modelos/xc60/Especificacoes	/br/modelos-volvo/novos-modelos/xc60	*
/br/Carros/Novos-Modelos/xc60/Galeria	/br/modelos-volvo/novos-modelos/xc60	*
/uk/Coronavirus	/uk/COVID-19-Update	*
/de/DerneueVolvoXC60	/de/modelle/neuwagen/der-neue-volvo-xc60	*
/es/Discover-Volvo/Forward-Thinking	/es/Discover-Volvo	*
/es/Discover-Volvo/Nyc-Sleep	/es/Discover-Volvo	*
/fi/Discover-Volvo/Forward-Thinking	/fi/Discover-Volvo	*
/fi/Discover-Volvo/Nyc-Sleep	/fi/Discover-Volvo	*
/ro-md/Discover-Volvo/Forward-Thinking	/ro-md/Discover-Volvo	*
/ro-md/Discover-Volvo/Nyc-Sleep	/ro-md/Discover-Volvo	*
/ru-md/Discover-Volvo/Forward-Thinking	/ru-md/Discover-Volvo	*
/ru-md/Discover-Volvo/Nyc-Sleep	/ru-md/Discover-Volvo	*
/ru/Discover-Volvo/Forward-Thinking	/ru/Discover-Volvo	*
/ru/Discover-Volvo/Nyc-Sleep	/ru/Discover-Volvo	*
/uk/EscapeTheCity	/uk/about/our-company/news	*
/fr/Essai	/fr/outils/configurer-et-acceder/reserver-un-essai	*
/uk/FLEETV60	/uk/Cars/Business-Sales/Business-Offers/V60	*
/au/FindADealer	/au/find-a-dealer	*
/es/FormularioS60	/es/modelos/campanas-y-ofertas/oferta-s60-premium-edition	*
/es/FormularioV40	/es/modelos/campanas-y-ofertas/oferta-v40	*
/es/FormularioV40CC	/es/modelos/campanas-y-ofertas/oferta-v40-cross-country-edicion-especial	*
/es/FormularioV40R	/es/modelos/campanas-y-ofertas/oferta-v40-r-design	*
/es/FormularioV60	/es/modelos/campanas-y-ofertas/oferta-v60-premium-edition	*
/it-ch/I-richiami-di-Volvo	/it-ch/Progetta-e-acquista/ulteriori-informazioni/I-richiami-di-Volvo	*
/si/O-Volvu/Nase-zgodbe/Drive-E	/si/zakaj-volvo/inovacije/prihodnost-voznje	*
/si/O-Volvu/Nase-zgodbe/Drive-E/Cleanzone	/si/zakaj-volvo/inovacije/prihodnost-voznje	*
/si/O-Volvu/Nase-zgodbe/Drive-E/PlugIn-Hibridi	/si/zakaj-volvo/inovacije/prihodnost-voznje	*
/cz/O-nas/Nase-inovace/Drive-E	/cz/proc-volvo/inovace/budoucnost-rizeni	*
/cz/O-nas/Nase-inovace/Drive-E/Twin-Engine	/cz/proc-volvo/inovace/budoucnost-rizeni	*
/cz/O-nas/Nase-inovace/IntelliSafe	/cz/proc-volvo/inovace/budoucnost-rizeni	*
/cz/O-nas/Nase-inovace/IntelliSafe/Autonomous-Driving	/cz/proc-volvo/inovace/budoucnost-rizeni	*
/cz/O-nas/Nase-inovace/IntelliSafe/Autonomous-Driving/C26	/cz/proc-volvo/inovace/budoucnost-rizeni	*
/cz/O-nas/Nase-inovace/IntelliSafe/Autonomous-Driving/Drive-Me	/cz/proc-volvo/inovace/budoucnost-rizeni	*
/cz/O-nas/Nase-inovace/IntelliSafe/Autonomous-Driving/How-it-works	/cz/proc-volvo/inovace/budoucnost-rizeni	*
/cz/O-nas/Nase-inovace/IntelliSafe/Narazove-testy-NCAP	/cz/proc-volvo/inovace/budoucnost-rizeni	*
/cz/O-nas/Nase-inovace/Sensus	/cz/proc-volvo/inovace/budoucnost-rizeni	*
/cz/O-nas/Nase-inovace/Sensus/Connected-car	/cz/proc-volvo/inovace/budoucnost-rizeni	*
/cz/O-nas/Nase-inovace/Sensus/Let-us-entertain-you	/cz/proc-volvo/inovace/budoucnost-rizeni	*
/cz/O-nas/Nase-inovace/Sensus/Life-made-easy	/cz/proc-volvo/inovace/budoucnost-rizeni	*
/cz/O-nas/Our-Innovation-Brands/Drive-E	/cz/proc-volvo/inovace/budoucnost-rizeni	*
/cz/O-nas/Our-Innovation-Brands/Drive-E/Twin-Engine	/cz/proc-volvo/inovace/budoucnost-rizeni	*
/cz/O-nas/Our-Innovation-Brands/IntelliSafe	/cz/proc-volvo/inovace/budoucnost-rizeni	*
/cz/O-nas/Our-Innovation-Brands/IntelliSafe/Autonomous-Driving	/cz/proc-volvo/inovace/budoucnost-rizeni	*
/cz/O-nas/Our-Innovation-Brands/IntelliSafe/Autonomous-Driving/C26	/cz/proc-volvo/inovace/budoucnost-rizeni	*
/cz/O-nas/Our-Innovation-Brands/IntelliSafe/Autonomous-Driving/Drive-Me	/cz/proc-volvo/inovace/budoucnost-rizeni	*
/cz/O-nas/Our-Innovation-Brands/IntelliSafe/Autonomous-Driving/How-it-works	/cz/proc-volvo/inovace/budoucnost-rizeni	*
/cz/O-nas/Our-Innovation-Brands/IntelliSafe/Narazove-testy-NCAP	/cz/proc-volvo/inovace/budoucnost-rizeni	*
/cz/O-nas/Our-Innovation-Brands/Sensus	/cz/proc-volvo/inovace/budoucnost-rizeni	*
/cz/O-nas/Our-Innovation-Brands/Sensus/Connected-car	/cz/proc-volvo/inovace/budoucnost-rizeni	*
/cz/O-nas/Our-Innovation-Brands/Sensus/Let-us-entertain-you	/cz/proc-volvo/inovace/budoucnost-rizeni	*
/cz/O-nas/Our-Innovation-Brands/Sensus/Life-made-easy	/cz/proc-volvo/inovace/budoucnost-rizeni	*
/be/Ontdekkingsdagen	/be	*
/dk/Oplev-Volvo/Forward-Thinking	/dk/Oplev-Volvo	*
/dk/Oplev-Volvo/Nyc-Sleep	/dk/Oplev-Volvo	*
/jp/Our-Innovation/Drive-E	/jp/why-volvo/human-innovation/future-of-driving	*
/jp/Our-Innovation/Drive-E/Twin-Engine	/jp/why-volvo/human-innovation/future-of-driving	*
/nl-be/Over-Volvo/Innovaties/Drive-E	/nl-be/waarom-volvo/innovaties/future-of-driving	*
/nl-be/Over-Volvo/Innovaties/Drive-E/CNG	/nl-be/waarom-volvo/innovaties/future-of-driving	*
/nl-be/Over-Volvo/Innovaties/Drive-E/Electrification	/nl-be/waarom-volvo/innovaties/future-of-driving	*
/nl-be/Over-Volvo/Innovaties/Drive-E/Twin-Engine	/nl-be/waarom-volvo/innovaties/future-of-driving	*
/nl-be/Over-Volvo/Innovaties/Drive-E/Volvo-hybride	/nl-be/waarom-volvo/innovaties/future-of-driving	*
/nl-be/Over-Volvo/Innovaties/IntelliSafe	/nl-be/waarom-volvo/innovaties/future-of-driving	*
/nl-be/Over-Volvo/Innovaties/IntelliSafe/Autopilot	/nl-be/waarom-volvo/innovaties/future-of-driving	*
/nl-be/Over-Volvo/Innovaties/IntelliSafe/Autopilot/C26	/nl-be/waarom-volvo/innovaties/future-of-driving	*
/nl-be/Over-Volvo/Innovaties/Sensus	/nl-be/waarom-volvo/innovaties/future-of-driving	*
/nl-be/Over-Volvo/Innovaties/Sensus/Send-to-Car	/nl-be/waarom-volvo/innovaties/future-of-driving	*
/nl-be/Over-Volvo/Innovaties/Sensus/Sensus-Connect	/nl-be/waarom-volvo/innovaties/future-of-driving	*
/ie/RSA	/ie/own/enjoy/road-side-assistance	*
/be/RechargeNews	/nl-be/modellen/gamma/xc40-recharge	*
/au/Runout	/au/buy/sales/offers/my17-runout	*
/es/S60	/es/modelos/nuevos-modelos-volvo/s60	*
/fr/S60	/fr/gamme/modeles/s60	*
/uk/S60	/uk/cars/new-models/s60	*
/us/S60	/us/cars/new-models/s60	*
/uk/S60Accessories	/uk/Cars/New-Models/S60/Accessories	*
/uk/S60CrossCountry	/uk/cars/new-models/s60/variants	*
/uk/S60Polestar	/uk/Cars/New-Models/S60/Variants/Polestar	*
/uk/S60Rdesign	/uk/cars/new-models/s60/variants	*
/be/S60brochures	/be	*
/uk/S60concept	/uk/cars/new-models/s60	*
/us/S60offers	/us/shopping-tools/purchase/offers/s60	*
/nl/S80	/nl/modellen/model/s80	*
/uk/S80	/uk/cars/new-models/s80	*
/uk/S80testdrive	/uk/cars/new-models/s80/test-drive	*
/uk/S90R-Design	/uk/cars/new-models/s90/r-design	*
/at/Service-und-Zubehoer/Mehr-entdecken/Sensus-Connect	/at/warum-volvo/unsere-innovationen/zukunft-des-fahrens	*
/au/Servicing	/au/own/maintenance/smartcare	*
/si/Servis-in-dodatna-oprema/Dodatna-oprema/Sensus-Connect	/si/zakaj-volvo/inovacije/prihodnost-voznje	*
/au/Showroom/S60/Gallery/Exterior	/au/cars/new-models/s60	*
/au/Showroom/V50	/au/cars/new-models/v60	*
/au/Showroom/XC70	/au/cars/new-models/xc70	*
/au/Showroom/XC90	/au/cars/new-models/xc90	*
/au/Showroom/newC70/gallery	/au/cars/model-lineup	*
/de/Showroom/V70	/de/Deutschland	*
/fr/Showroom/S60/	/fr/gamme/modeles/s60	*
/fr/Showroom/S60/Specifications/Features/	/fr/gamme/modeles/s60/specifications	*
/fr/Showroom/S60/Specifications/OptionsAccessories/	/fr/gamme/modeles/s60/specifications	*
/fr/Showroom/S60/Specifications/TechnicalSpecifications/	/fr/gamme/modeles/s60/specifications	*
/fr/Showroom/S60/testdrive/	/fr/outils/configurer-et-acceder/reserver-un-essai	*
/fr/Showroom/XC90/	/fr/gamme/modeles/xc90	*
/fr/Showroom/XC90/BuildPrice/	/fr/outils/configurer-et-acceder/brochure-et-tarif	*
/fr/Showroom/XC90/Gallery/Exterior/	/fr/gamme/modeles/xc90/galerie	*
/fr/Showroom/XC90/Gallery/Interior/	/fr/gamme/modeles/xc90/galerie	*
/fr/Showroom/XC90/Specifications/Features/	/fr/gamme/modeles/xc90/specifications	*
/fr/Showroom/XC90/Specifications/OptionsAccessories/	/fr/gamme/modeles/xc90/accessoires	*
/fr/Showroom/XC90/Specifications/TechnicalSpecifications/	/fr/gamme/modeles/xc90/specifications	*
/fr/Showroom/XC90/testdrive/	/fr/outils/configurer-et-acceder/reserver-un-essai	*
/ro/Showroom/S60/Specifications/Technical	/ro/cars/new-models/s60	*
/se/Showroom/XC90	/se/bilar/modeller/xc90	*
/uk/Showroom/S60	/uk/cars/new-models/s60	*
/uk/Showroom/V70	/uk/cars/new-models/v60	*
/de/Sicherheitsgarantie	/de/Zubehoer-und-Services/Services/Serviceleistungen	*
/pt/Sobre-a-Volvo/A-Nossa-Empresa/A-nossa-historia	/pt/Porque-a-Volvo/A-nossa-historia	*
/sk/Spoznajte-Volvo/Forward-Thinking	/sk/Spoznajte-Volvo	*
/sk/Spoznajte-Volvo/Nyc-Sleep	/sk/Spoznajte-Volvo	*
/at/StoryTelling-noch-nicht-editiert/Forward-Thinking	/at/volvo-entdecken	*
/at/StoryTelling-noch-nicht-editiert/Nyc-Sleep	/at/volvo-entdecken	*
/de-ch/StoryTelling-noch-nicht-editiert/Forward-Thinking	/de-ch/volvo-entdecken	*
/fr-ch/StoryTelling-noch-nicht-editiert/Forward-Thinking	/fr-ch/Volvo-Entdecken	*
/it-ch/StoryTelling-noch-nicht-editiert/Forward-Thinking	/it-ch/Volvo-Entdecken	*
/au/TakeTheDawn	/au/cars/new-models/v60-cross-country	*
/pt/Test-Page/Discover-Volvo/Forward-Thinking	/pt/sobre-a-volvo/as-nossas-estorias/discover-volvo-	*
/pt/Test-Page/Discover-Volvo/Nyc-Sleep	/pt/sobre-a-volvo/as-nossas-estorias/discover-volvo-	*
/fr-be/Trouvez%20votre%20distributeur	/fr-be/acheter/votre-nouvelle-volvo/trouvez-votre-concessionnaire	*
/nl/V40/accessoires	/nl/modellen/model/v40/accessoires	*
/es/V40	/es/modelos/nuevos-modelos-volvo/v40	*
/ie/V40	/ie/cars/new-models/v40	*
/nl/V40	/nl/modellen/model/v40	*
/uk/V40	/uk/cars/new-models/v40	*
/nl/V40CrossCountry	/nl/modellen/model/v40-cross-country	*
/uk/V40CrossCountry	/uk/cars/new-models/v40/variants	*
/uk/V40RDesign	/uk/cars/new-models/v40/variants	*
/es/V60	/es/modelos/nuevos-modelos-volvo/v60	*
/ie/V60	/ie/cars/new-models/v60	*
/uk/V60	/uk/cars/new-models/v60	*
/uk/V60BusinessEdition	/uk/cars/new-models/v60/variants	*
/uk/V60CrossCountry	/uk/cars/new-models/v60/variants	*
/uk/V60TwinEngine	/uk/cars/new-models/v60-twin-engine	*
/uk/V60business	/uk/cars/business-sales/v60	*
/de/V60cc	/de/v/cars/v60-cross-country	*
/us/V60crosscountry	/us/cars/new-models/v60-cross-country	*
/uk/V60pluginhybrid	/uk/cars/new-models/v60/variants	*
/nl/V60zakenauto	/nl/modellen/model/v60	*
/uk/V70BusinessEdition	/uk/cars/new-models/v70/variants	*
/volvocars.de/V90	/de/v/cars/V90-hybrid	*
/uk/V90CC	/uk/cars/new-models/v90/variants/cross-country	*
/uk/V90CrossCountry	/uk/cars/new-models/v90/variants/cross-country	*
/uk/V90testdrive	/uk/cars/new-models/v90/test-drive/Personal	*
/be/VNF-poster	/be	*
/uk/VOROceanRace	/uk/Cars/New-Models/V90/Variants/Volvo-Ocean-Race	*
/ro/Vanzari/Aplicatii-si-servicii/Sensus-Connect	/ro/despre-volvo/inovatie-umana/viitorul-sofatului	*
/nl-be/Vind%20uw%20verdeler	/nl-be/Kopen/Uw-nieuwe-Volvo/Volvo-verdelers	*
/de-ch/Volvo-Entdecken/Nyc-Sleep	/de-ch/volvo-entdecken	*
/de-ch/Volvo-Entdecken/forward-thinking	/de-ch/volvo-entdecken	*
/fr-ch/Volvo-Entdecken/Forward-Thinking	/fr-ch/Volvo-Entdecken	*
/fr-ch/Volvo-Entdecken/Nyc-Sleep	/fr-ch/Volvo-Entdecken	*
/it-ch/Volvo-Entdecken/Forward-Thinking	/it-ch/Volvo-Entdecken	*
/it-ch/Volvo-Entdecken/Nyc-Sleep	/it-ch/Volvo-Entdecken	*
/at/Volvo-Rueckruf-Information	/at/Ueber-Volvo/Unsere-Innovationen/Zukunft-des-Fahrens/Sicherheit/Volvo-Rueckruf-Information	*
/uk/VolvoMoments	/uk/about/humanmade/news	*
/au/VolvoOwnership/Accessories	/au/cars/new-models/s60	*
/de/VolvoS90	/de/modelle/neuwagen/der-neue-s90	*
/uk/WinterWheels	/uk/accessories	*
/de/XC40	/de/v/cars/xc40-electric  *
/es/XC60	/es/modelos/nuevos-modelos-volvo/xc60	*
/ie/XC60	/ie/cars/new-models/xc60	*
/us/XC60	/us/cars/new-models/xc60	*
/nl/XC70	/nl/modellen/model/xc70	*
/uk/XC70	/uk/cars/new-models/xc70	*
/br/XC90	/br/modelos-volvo/novos-modelos/o-novo-xc90	*
/us/XC90offers	/us/shopping-tools/purchase/offers/xc90	*
/au/a-million-more	/au/why-volvo/human-innovation/future-of-driving/safety/a-million-more	*
/de-ch/a-million-more	/de-ch/Weshalb-Volvo/Human-Innovation/Future-of-driving/Sicherheit/A-million-more	*
/lu/a-million-more	/lu/v/car-safety/a-million-more	*
/se/a-new-beginning	/se/bilar/modeller/xc90	*

/be/accessoires-fr	/fr-be/accessoires	*
/be/accessoires-nl	/nl-be/accessoires	*
/be/accessoirewielen	/nl-be/accessoires/wielen-en-velgen/	*
/be/accessoirewielenpromotie	/nl-be/accessoires/seizoensactie	*

/uk/accidentrepair	/uk/Own/Maintenance/Accident-and-Repair	*
/es/acerca-de-volvopania/experiencia-volvo	/es/acerca-de-volvo/valores/formacion-conductores	*
/es/acerca-de-volvopania/experiencia-volvo/nuestras-fabricas	/es/acerca-de-volvo/valores/formacion-conductores/fabricas	*
/es/acerca-de-volvopania/noticias-volvo	/es/acerca-de-volvo/historia/noticias-eventos/noticias-motor	*
/es/acerca-de-volvopania/origen-volvo	/es/acerca-de-volvopania/origen	*
/es/acerca-de-volvopania/volvo-retail-experience	/es/acerca-de-volvo/historia/volvo-retail	*
/fr/achat/construire-votre-projet/accessoires   /fr/l/accessoires  *
/fr/achat/construire-votre-projet/accessoires/collection-lifestyle	/fr/achat/construire-votre-projet/accessoires	*
/fr/achat/construire-votre-projet/accessoires/les-sieges-enfant	 /fr/l/les-sieges-enfant  *
/fr/achat/construire-votre-projet/accessoires/optimisation-moteur-polestar	 /fr/l/optimisation-moteur-polestar  *
/fr/achat/construire-votre-projet/accessoires/recharge	 /fr/l/recharge  *
/fr/achat/construire-votre-projet/accessoires/roues   /fr/l/roues  *
/fr/achat/construire-votre-projet/accessoires/service-location-accessoires	/fr/l/service-location-accessoires  *
/fr/achat/construire-votre-projet/accessoires/sieges-enfant	/fr/Achat/Construire-votre-projet/Accessoires/Les-sieges-enfant	*
/fr/achat/construire-votre-projet/accessoires/sieges-enfant/Item-04B4A44C-6B0C-47FC-9731-C98E58540CD4	/fr/achat/construire-votre-projet/accessoires/sieges-enfant	*
/fr/achat/construire-votre-projet/accessoires/sieges-enfant/Item-630CAA87-FD4F-41E8-9958-422D51171DA2	/fr/achat/construire-votre-projet/accessoires/sieges-enfant	*
/fr/achat/construire-votre-projet/accessoires/sieges-enfant/Item-F4DC3167-208B-4725-998D-574EEF8FB106	/fr/achat/construire-votre-projet/accessoires/sieges-enfant	*
/fr/achat/construire-votre-projet/accessoires/sieges-enfant/configurateur-de-siege-enfant	/fr/Achat/Construire-votre-projet/Accessoires/Les-sieges-enfant	*
/fr/achat/construire-votre-projet/accessoires/sieges-enfant/teste-pour-la-vie	/fr/Achat/Construire-votre-projet/Accessoires/Les-sieges-enfant	*
/fr/achat/construire-votre-projet/entretien-et-garantie  /fr/l/entretien-et-garantie/  *
/fr/achat/construire-votre-projet/financement-et-assurance   /fr/l/financement-et-assurance  *
/fr/achat/construire-votre-projet/financement-et-assurance/credit-a-la-carte    /fr/l/credit-a-la-carte  *
/fr/achat/construire-votre-projet/financement-et-assurance/credit-bail    /fr/l/credit-bail  *
/fr/achat/construire-votre-projet/financement-et-assurance/lld   /fr/l/location-longue-duree  *
/fr/achat/construire-votre-projet/financement-et-assurance/loa  /fr/l/location-avec-option-d-achat  *
/fr/achat/construire-votre-projet/financement-et-assurance/volvo-assurance  /fr/l/volvo-car-assurance/  *
/fr/achat/construire-votre-projet/sieges-enfant	/fr/Achat/Construire-votre-projet/Accessoires/Les-sieges-enfant	*
/fr/achat/decouvrir-et-essayer/trouver-un-concessionnaire	/fr/Outils/Configurer-et-acceder/Trouver-un-concessionnaire	*
/ro/achizitie/aplicatii-si-servicii/sensus-connect	/ro/vanzari/aplicatii-si-servicii/sensus-connect	*
/be/action-saisonniere	/fr-be/accessoires/action-saisonniere	*
/lu/action-saisonniere	/lu/accessoires/action-saisonniere	*
/be/actionroueshiver	/fr-be/accessoires/action-saisonniere	*
/lu/actionroueshiver	/lu/Accessoires/Action-saisonniere	*
/be/actionsaisonniere/Volvowheelsapp	/nl-be/accessoires/redirect/volvowheelsapp	*
/be/actionsaisonniere/rouesete	/fr-be/accessoires/roues-et-jantes/roues-ete-completes	*
/lu/actionsaisonniere/Volvowheelsapp	/nl-be/accessoires/redirect/volvowheelsapp	*
/lu/actionsaisonniere/rouesete	/lu/accessoires/action-saisonniere	*
/be/actionsaisonniere	/fr-be/accessoires/action-saisonniere	*
/lu/actionsaisonniere	/lu/accessoires/action-saisonniere	*
/uk/affinity	/uk/leasing/affinity-offers	*
/se/agande/agande/business-lease	/se/kop/finansiering/volvo-business/business-lease	*
/se/agande/agande/care-by-volvo	/se/kop/finansiering/care-by-volvo	*
/se/agande/agande/finansiering	/se/kop/finansiering-och-tjanster/privat	*
/se/agande/agande/forsakring	/se/kop/finansiering/forsakring	*
/se/agande/agande/garantier	/se/kop/finansiering/garantier	*
/se/agande/agande/privatleasing	/se/kop/finansiering/privatleasing	*
/se/agande/agande/volvo-business	/se/kop/finansiering/volvo-business	*
/se/agande/agande/volvo-business/business-lease	/se/kop/finansiering/volvo-business/business-lease	*
/se/agande/agande/volvokort	/se/kop/finansiering/volvokort	*
/se/agande/service-och-underhall	/se/aga/service/service-och-underhall	*
/se/agande/service-och-underhall/bilvard	/se/kop/service-och-underhall/bilvard	*
/se/agande/service-och-underhall/connected-service-booking	/se/kop/teknik-och-tjanster/connected-service-booking	*
/se/agande/service-och-underhall/dack	/se/aga/service/service-och-underhall/dack	*
/se/agande/service-och-underhall/falgkonfiguratorn	/se/aga/accessories/falgkonfiguratorn	*
/se/agande/service-och-underhall/fristaende-verkstader	/se/kop/service-och-underhall/volvobutiken	*
/se/agande/service-och-underhall/glas	/se/aga/service/service-och-underhall/glas	*
/se/agande/service-och-underhall/originaldelar	/se/kop/service-och-underhall/originaldelar	*
/se/agande/service-och-underhall/originalservice	/se/kop/service-och-underhall/originalservice	*
/se/agande/service-och-underhall/personlig-servicetekniker	/se/kop/service-och-underhall/personlig-servicetekniker	*
/se/agande/service-och-underhall/polestar-performance-parts	/se/aga/accessories/polestar-performance-parts	*
/se/agande/service-och-underhall/serviceavtal	/se/kop/service-och-underhall/serviceavtal	*
/se/agande/service-och-underhall/tillbehor	/se/aga/accessories/tillbehor	*
/se/agande/service-och-underhall/volvobutiken	/se/kop/service-och-underhall/fristaende-verkstader	*
/se/agande/tjanster/mobilappar	/se/kop/teknik-och-tjanster/mobilappar	*
/se/agande/tjanster/send-to-car	/se/kop/uppkopplad/send-to-car	*
/se/agande/tjanster/smartphone-integration	/se/kop/uppkopplad/smartphone-integration	*
/se/agande/tjanster/smartphone-integration/android-auto	/se/kop/uppkopplad/smartphone-integration/android-auto	*
/se/agande/tjanster/smartphone-integration/apple-carplay	/se/kop/uppkopplad/smartphone-integration/apple-carplay	*
/se/agande/tjanster/support	/se/aga/information/support	*
/se/agande/tjanster/volvo-assistans	/se/aga/service-och-underhall/volvo-assistans	*
/se/agande/utforska/barnsakerhet	/se/aga/information/barnsakerhet	*
/se/agande/utforska/barnsakerhet/barnsakerhet-utvecklad-av-volvo	/se/aga/information/barnsakerhet/barnsakerhet-utvecklad-av-volvo	*
/se/agande/utforska/barnsakerhet/children-and-cars-manual	/se/aga/information/barnsakerhet/barnsakerhet-utvecklad-av-volvo/barn-och-bilar	*
/se/agande/utforska/bilbarnstolar	/se/aga/accessories/bilbarnstolar	*
/se/agande/utforska/bilbarnstolar/bilbarnstolarna	/se/aga/accessories/bilbarnstolar/bilbarnstolarna	*
/se/agande/utforska/bilbarnstolar/bilbarnstolskonfiguratorn	/se/aga/accessories/bilbarnstolar/bilbarnstolskonfiguratorn	*
/se/agande/utforska/bilbarnstolar/testade-for-verkligheten	/se/aga/accessories/bilbarnstolar/testade-for-verkligheten	*
/be/aircocheck	/nl-be/naverkoop/onderhoud/onderhoud-en-reparatie/aircocheck	*
/cz/akce	/cz/sluzby/vyber-a-koupe/akcni-nabidky	*
/au/all-cars-my13/volvo-s60/details/pages	/au/cars/new-models/s60	*
/au/all-cars-my13/volvo-s60/which/au/buy/design-and-buy/car-configurator	/au/buy/design-and-buy/create-your-own#/model	*
/au/all-cars-my13/volvo-v40	/au/cars/new-models/v40	*
/au/all-cars-my13/volvo-v40/r-design	/au/cars/new-models/v40	*
/au/all-cars-my13/volvo-v40/r-design/pages	/au/cars/new-models/v40/editions	*
/au/all-cars-my13/volvo-v40/specifications/pages	/au/cars/new-models/v40/specifications	*
/au/all-cars-my13/volvo-v40/which	/au/cars/new-models/v40	*
/au/all-cars-my13/volvo-v40/which/pages	/au/cars/new-models/v40/editions	*
/au/all-cars-my13/volvo-v50/which/pages	/au/cars/new-models/v60	*
/au/all-cars-my13/volvo-v60	/au/cars/new-models/v60	*
/au/all-cars-my13/volvo-xc60/which/pages	/au/cars/new-models/xc60	*
/ru/all-cars-my13/volvo-s60	/ru/cars/new-models/s60	*
/ru/all-cars-my13/volvo-s80	/ru/cars/new-models/s80	*
/ru/all-cars-my13/volvo-xc60	/ru/cars/new-models/xc60	*
/ru/all-cars-my13/volvo-xc70	/ru/cars/new-models/xc70	*
/ru/all-cars-my13/volvo-xc90	/ru/cars/new-models/all-new-xc90	*
/sk/all-cars-my13/volvo-s60	/sk/cars/new-models/s60	*
/sk/all-cars-my13/volvo-s60/360views/pages	/sk/cars/new-models/s60	*
/sk/all-cars-my13/volvo-s60/details/pages	/sk/cars/new-models/s60	*
/sk/all-cars-my13/volvo-s60/which/pages	/sk/cars/new-models/s60	*
/tr/all-cars-my13/volvo-s60	/tr/modeller/new-models/s60	*
/tr/all-cars-my13/volvo-s60/360views/pages	/tr/modeller/new-models/s60	*
/za/all-cars-my13/volvo-v40	/za/cars/new-models/v40	*
/de-CH/all-cars_my13/volvo-v60	/de-CH/modelle/unsere-modelle/volvo-v60	*
/de-CH/all-cars_my13/volvo-v60/360views/pages	/de-CH/modelle/unsere-modelle/volvo-v60	*
/de-CH/all-cars_my13/volvo-v60/details/pages	/de-CH/modelle/unsere-modelle/volvo-v60	*
/de-CH/all-cars_my13/volvo-v60/which/pages	/de-CH/modelle/unsere-modelle/volvo-v60	*
/it-CH/all-cars_my13/volvo-xc70/which/pages	/it-CH/nos-modelli/modelli/volvo-xc70	*
/it-CH/all-cars_my13/volvo-xc90	/it-CH/nos-modelli/modelli/volvo-xc90	*
/it-CH/all-cars_my13/volvo-xc90/360views/pages	/it-CH/nos-modelli/modelli/volvo-xc90	*
/it-CH/all-cars_my13/volvo-xc90/details/pages	/it-CH/nos-modelli/modelli/volvo-xc90	*
/it-CH/all-cars_my13/volvo-xc90/which/pages	/it-CH/nos-modelli/modelli/volvo-xc90	*
/au/all-new-volvo-xc90	/au/cars/new-models/xc90	*
/br/all-new-volvo-xc90	/br/modelos-volvo/novos-modelos/o-novo-xc90	*
/cz/all-new-volvo-xc90	/cz/vozy/modely/volvo-xc90	*
/fi/all-new-volvo-xc90	/fi/all-cars/all-new-volvo-xc90/Pages/default.aspx	*
/fr/all-new-volvo-xc90	/fr/all-cars/all-new-volvo-xc90/pages/default.aspx	*
/it/all-new-volvo-xc90	/it/modelli/volvo/nuova-xc90	*
/uk/all-new-volvo-xc90	/uk/cars/new-models/all-new-xc90	*
/us/all-newvolvoxc90	/us/cars/new-models/all-new-xc90	*
/us/allnew-XC60	/us/cars/new-models/all-new-xc60	*
/us/allnewXC60	/us/cars/new-models/all-new-xc60	*
/uk/allnewXC90	/uk/cars/new-models/all-new-xc90	*
/no/allnewxc90	/no/cars/new-models/helt-nye-xc90	*
/ch/alpiq	/de-ch/Redirects/Alpiq	*
/language-selector/americas/canada	/ca	*
/se/anewbeginning	/se/bilar/modeller/xc90	*
/de/anschlussgarantie	/de/zubehoer-und-services/zubehoer-und-services/anschlussgarantie	*
/jp/anshinsmavo	/jp/buy/sales/finance/anshinsmavo	*
/nl/apk	/nl/l/mijn-volvo/apk/  *
/us/aplaceforeverything	/us/v/cars/xc40	*
/uk/apprentice	/uk/about/our-company/apprenticeships	*
/be/apps	/be	*
/be/apresvente	/fr-be/apres-vente	*
/lu/apresvente	/lu/apres-vente	*
/be/assistance	/be	*
/ch/assistance	/de-ch/Redirects/Volvo-Assistance	*
/de/assistance	/de/zubehoer-und-services/dokumente-und-hilfe/volvo-assistance	*
/lu/assistance	/lu/acheter/services-volvo/extended-services/assistance-volvo	*
/nl/assistance	/nl/Service-en-Accessoires/Onderhoud-en-reparatie/Service-by-Volvo/Assistance	*
/be/assistance-fr	/fr-be/acheter/services-volvo/extended-services/volvo-assistance	*
/be/assistance-nl	/nl-be/kopen/volvo-diensten/extended-services/volvo-assistance	*
/dk/autoriserede-forhandlere	/dk/find-a-dealer	*
/jp/avex-volvo	/jp/cp/avex-volvo	*
/de/awards	/de/Volvo/Mehr-Volvo/Awards	*
/us/babyonboard	/us/cars/new-models/suv	*
/lu/berline	/lu/v/cars/sedan	*
/at/betroffenenrechte	/at/forms/subject-rights-request	*
/se/bilbarnstolar	/se/AGA/Tillbehor/Bilbarnstolar	*
/uk/birdman	/uk/About/HumanMade/Discover-Volvo/Birdman	*
/ch/blog	/de-ch/redirects/blog	*
/cz/bluetooth	/cz/support/topics/connectivity	*
/ch/unplugged  /de-ch/l/redirects/unplugged  *
/nl/bluetooth	/nl/service/uw-volvo/support	*
/mt/book%20a%20test%20drive	/mt/Forms/tdr	*
/en-bh/book-a-test-drive	/en-bh/Forms/tdr-en	*
/il/branches	/il/Find-a-Dealer	*
/lu/break	/lu/v/cars/wagon	*
/nl/brochure	/nl/ontdek/samenstellen/brochure	*
/uk/brochure	/uk/cars/ebrochure	*
/de/business	/de/beratung-und-kauf/ueberblick/business/geschaeftskunden	*
/fi/business	/fi/mallisto/volvo-business-mallit	*
/de/business-praemie	/de/Deutschland	*
/uk/businesscontact	/uk/cars/business-sales/contact	*
/se/businesslease	/se/agande/agande/volvo-business/business-lease	*
/uk/c30 /uk/cars/new-models/s60 *
/fr/flotte   /fr/outils/configurer-et-acceder/demander-une-offre/professionnel-flotte        *
/it/flotte   /it/modelli/flotte-volvo        *
/at/forms/subject-rights-request-form    /<market>/subject-rights-request-form  *
/bg/forms/subject-rights-request-form    /<market>/subject-rights-request-form  *
/et-ee/forms/subject-rights-request-form    /<market>/subject-rights-request-form  *       
/fr-be/forms/subject-rights-request-form-fr    /<market>/subject-rights-request-form  *
/hr/forms/subject-rights-request-form    /<market>/subject-rights-request-form  *
/is/forms/subject-rights-request-form    /<market>/subject-rights-request-form  *  
/it/forms/subject-rights-request-form    /<market>/subject-rights-request-form  *
/lt-lt/forms/subject-rights-request-form    /<market>/subject-rights-request-form  *
/lv-lv/forms/subject-rights-request-form    /<market>/subject-rights-request-form  *
/nl-be/forms/subject-rights-request-form-nl    /<market>/subject-rights-request-form  *
/ro/forms/subject-rights-request-form    /<market>/subject-rights-request-form  *
/si/forms/subject-rights-request-form    /<market>/subject-rights-request-form  *
/sk/forms/subject-rights-request-form    /<market>/subject-rights-request-form  *
/it/milanodesignweek/	/it/modelli/esplora-i-modelli	*
/it/models/	/it/modelli/esplora-i-modelli	*
/it/models/Volvo-C30	/it/modelli/esplora-i-modelli	*
/it/models/Volvo-C70	/it/modelli/esplora-i-modelli	*
/it/models/Volvo-S40	/it/modelli/esplora-i-modelli	*
/it/models/Volvo-S60	/it/modelli/volvo/s60	*
/it/models/Volvo-S80	/it/modelli/volvo/s80	*
/it/models/Volvo-V50	/it/modelli/esplora-i-modelli	*
/it/models/Volvo-V70-New	/it/modelli/volvo/v70	*
/it/models/Volvo-XC70	/it/modelli/volvo/xc70	*
/it/models/Volvo-XC90	/it/modelli/volvo/nuova-xc90	*
/ch/s60crosscountry        /de-ch/Redirects/S60cc  *
/us/s60rdesign     /us/build/sedan/s60#r-design%20subscription     *
/it/selekt	/it/modelli/volvo-selekt	*
/it/v40_fleet_testdrive	/it/modelli/volvo/v40	*
/it/v40provalaperprimo	/it/modelli/volvo/v40	*
/it/v60pluginhybrid	/it/modelli/volvo/v60	*
/ch/v60twinengine   /de-ch/Redirects/v60te  *
/se/bygg	/se/bilar/bygg-din-volvo	*


/ch/carcare	/de-ch/Redirects/carcare	*
/de/careers	/de/volvo/unser-unternehmen/karriere	*
/uk/careers	/uk/about/our-company/this-is-volvo-cars	*
/br/carros/c26	/br/modelos-volvo/carros-conceito	*
/se/erbjudanden  /se/erbjudanden/bilar  *
/br/carros/concept-cars/c26	/br/modelos-volvo/carros-conceito	*
/br/carros/modelos	/br/modelos-volvo/modelos	*
/br/carros/modelos-volvo	/br/modelos-volvo/modelos	*
/br/carros/modelos-volvo/o-novo-xc90	/br/modelos-volvo/novos-modelos/o-novo-xc90	*
/br/carros/modelos-volvo/o-novo-xc90/acess%C3%B3rios	/br/modelos-volvo/novos-modelos/o-novo-xc90	*
/br/carros/modelos-volvo/o-novo-xc90/acessorios	/br/modelos-volvo/novos-modelos/o-novo-xc90	*
/br/carros/modelos-volvo/o-novo-xc90/brand-campaign	/br/modelos-volvo/novos-modelos/o-novo-xc90	*
/br/carros/modelos-volvo/o-novo-xc90/edicao-especial	/br/modelos-volvo/novos-modelos/o-novo-xc90	*
/br/carros/modelos-volvo/o-novo-xc90/versoes	/br/modelos-volvo/novos-modelos/o-novo-xc90/versoes	*
/br/carros/modelos-volvo/s60	/br/modelos-volvo/novos-modelos/s60	*
/br/carros/modelos-volvo/s60/acessorios	/br/modelos-volvo/novos-modelos/s60	*
/br/carros/modelos-volvo/s60/especificacoes	/br/modelos-volvo/novos-modelos/s60	*
/br/carros/modelos-volvo/s60/galeria	/br/modelos-volvo/novos-modelos/s60	*
/br/carros/modelos-volvo/s60/versoes	/br/modelos-volvo/novos-modelos/s60/versoes	*
/br/carros/modelos-volvo/s60/versoes/s60-r-design	/br/modelos-volvo/novos-modelos/s60/versoes/s60-r-design	*
/br/carros/modelos-volvo/s90	/br/modelos-volvo/novos-modelos/s90	*
/br/carros/modelos-volvo/xc60	/br/modelos-volvo/novos-modelos/xc60	*
/br/carros/modelos-volvo/xc60/especificacoes	/br/modelos-volvo/novos-modelos/xc60	*
/br/carros/modelos-volvo/xc60/galeria	/br/modelos-volvo/novos-modelos/xc60	*
/br/carros/modelos-volvo/xc60/versoes	/br/modelos-volvo/novos-modelos/xc60/versoes	*
/br/carros/modelos-volvo/xc60/versoes/xc60-comfort	/br/modelos-volvo/novos-modelos/xc60	*
/br/carros/modelos-volvo/xc60/versoes/xc60-dynamic	/br/modelos-volvo/novos-modelos/xc60	*
/br/carros/modelos-volvo/xc60/versoes/xc60-inscription	/br/modelos-volvo/novos-modelos/xc60/versoes/gasolina/xc60-inscription	*
/br/carros/modelos-volvo/xc60/versoes/xc60-kinetic	/br/modelos-volvo/novos-modelos/xc60	*
/br/carros/modelos-volvo/xc60/versoes/xc60-t5-r-design	/br/modelos-volvo/novos-modelos/xc60/versoes/gasolina/xc60-t5-r-design	*
/br/carros/opcoes/acess%C3%B3rios	/br/conveniencia/idealize-seu-volvo/solicite-acessorio	*
/us/certifiedbyvolvo	/us/shopping-tools/shop/certified-pre-owned	*
/us/certifiedpreowned	/us/shopping-tools/shop/certified-pre-owned	*
/ch/charge-and-drive	/de-ch/redirects/charge-and-drive	*
/br/chat/demo	/br/Porque-Volvo/Inovacao-Humana/Eletrificacao	*
/uk/chauffeur	/uk/buy/finance-sales/special-sales/chauffeur	*
/be/checkup-airco	/fr-be/apres-vente/entretien/entretien-et-reparation/checkup-d-airco	*
/lu/checkup-airco	/lu/apres-vente/entretien/entretien-et-reparation/checkup-d-airco	*
/be/checkup-automne	/fr-be/apres-vente/votre-volvo/entretien-et-reparation/checkup-saisonnier	*
/lu/checkup-automne	/lu/apres-vente/votre-volvo/entretien-et-reparation/checkup-saisonnier	*
/be/checkup-ete	/fr-be/apres-vente/votre-volvo/entretien-et-reparation/checkup-saisonnier	*
/lu/checkup-ete	/lu/apres-vente/votre-volvo/entretien-et-reparation/checkup-saisonnier	*
/be/checkup-hiver	/fr-be/apres-vente/entretien/entretien-et-reparation/checkup-d-hiver	*
/be/checkup-printemps	/fr-be/apres-vente/votre-volvo/entretien-et-reparation/checkup-saisonnier	*
/lu/checkup-printemps	/lu/apres-vente/votre-volvo/entretien-et-reparation/checkup-saisonnier	*
/be/checkupdeprintemps	/fr-be/apres-vente/votre-volvo/entretien-et-reparation/checkup-saisonnier	*
/lu/checkupdeprintemps	/lu/apres-vente/votre-volvo/entretien-et-reparation/checkup-saisonnier	*
/be/checkupdete	/fr-be/apres-vente/votre-volvo/entretien-et-reparation/checkup-saisonnier	*
/lu/checkupdete	/lu/apres-vente/votre-volvo/entretien-et-reparation/checkup-saisonnier	*
/be/checkupdhiver	/fr-be/apres-vente/votre-volvo/entretien-et-reparation/checkup-saisonnier	*
/lu/checkupdhiver	/lu/apres-vente/votre-volvo/entretien-et-reparation/checkup-saisonnier	*
/be/checkupsaisonnier	/fr-be/apres-vente/votre-volvo/entretien-et-reparation/checkup-saisonnier	*
/lu/checkupsaisonnier	/lu/apres-vente/votre-volvo/entretien-et-reparation/checkup-saisonnier	*
/be/checkupsaissonnier	/fr-be/apres-vente/votre-volvo/entretien-et-reparation/checkup-saisonnier	*
/lu/checkupsaissonnier	/lu/apres-vente/votre-volvo/entretien-et-reparation/checkup-saisonnier	*
/jp/child	/jp/about/our-stories/volvo-safety/child-safety	*
/jp/child/	/jp/about/our-stories/volvo-safety/child-safety	*
/uk/child-safety	/uk/About/Human-Innovation/Future-of-driving/Safety/Child-safety	*
/ch/child-seat	/de-ch/redirects/child-seat	*
/se/childhood	/se/OM-VOLVO/Foretaget/Partnerskap/World-Childhood-Foundation	*
/be/childsafety	/be	*
/ch/childseatconfigurator	/de-ch/Redirects/child-seat-configurator	*
/es/clientes/cuida-tu-volvo/volvo-loyalty	/es/servicios-cliente/mantenimiento/loyalty	*
/lu/clpw	/lu/apres-vente/votre-volvo/entretien-et-reparation/customer-lifetime-parts-warranty	*
/be/clpw-fr	/fr-be/apres-vente/votre-volvo/entretien-et-reparation/customer-lifetime-parts-warranty	*
/be/clpw-nl	/nl-be/naverkoop/uw-volvo/onderhoud-en-reparatie/customer-lifetime-parts-warranty	*
/uk/co-pilot	/uk/cars/business-sales/news	*
/jp/coat	/jp/own/maintenance/intelli-coat	*
/fr/collection	/fr/gamme/tous-les-modeles	*
/nl/collection	/nl/service/uw-volvo/accessoires#merchandise	*
/uk/compare	/uk/Buy/Research/Car-Comparison-Tool	*
/be/conceptcars	/be	*
/nl/conceptcars	/nl/Ontdek-Volvo/Innovaties/Toekomst-van-mobiliteit/Concepts	*
/uk/conceptcars	/uk/about/our-stories/concept-cars	*
/nl/concepts	/nl/Ontdek-Volvo/Innovaties/Toekomst-van-mobiliteit/Concepts	*
/be/concessionaires	/fr-be/acheter/votre-nouvelle-volvo/distributeurs	*
/lu/concessionaires	/lu/vente/configurez-et-achetez/trouvez-votre-concessionnaire	*
/fr/concessions	/fr/outils/configurer-et-acceder/trouver-un-concessionnaire	*
/be/concesssionaires	/fr-be/acheter/votre-nouvelle-volvo/distributeurs	*
/lu/concesssionaires	/lu/vente/configurez-et-achetez/trouvez-votre-concessionnaire	*
/be/confidentialite	/fr-be/footer/confidentialite	*
/lu/confidentialite	/lu/footer/confidentialite	*
/it/configura-la-tua-volvo/open	/it/Modelli/Esplora-i-modelli	*
/fr/configurateu/breaks-et-compactes/v90	/fr/configurateur/break/v90	*
/fr/configurateur/suv/xc90/t8-twin-engine-inscription-luxe	/fr/gamme/modeles/xc90-t8-twin-engine	*
/it/configuratore	/it/build	*
/us/connectedcar	/us/own/owner-info/sensus-connect	*
/be/connectedtouch	/be	*
/fr-be/contact	/fr-be/support/contact	*
/nl-be/contact	/nl-be/support/contact	*
/nl/contact	/nl/l/hulp-en-support/contact/  *
/uk/contact	/uk/Footer/Contact-Us	*
/ie/contactus	/ie/footer/contact-us	*
/uk/contactus	/uk/footer/contact-us	*
/br/conveni%C3%AAncia/aplicativos/volvo-on-call	/br/conveniencia/aplicativos/volvo-on-call	*
/br/conveniencia/aplicativos/carplay	/br/proprietario/informacao-proprietario/integracao-smartphone/apple-carplay	*
/br/conveniencia/aplicativos/volvo-on-call	/br/proprietario/informacao-proprietario/volvo-on-call	*
/br/conveniencia/aproveite-o-seu-volvo/carros-blindados	/br/conveniencia/aproveite-seu-volvo/carros-blindados	*
/br/conveniencia/aproveite-o-seu-volvo/garantia	/br/conveniencia/aproveite-seu-volvo/garantia	*
/br/conveniencia/aproveite-o-seu-volvo/recalls	/br/conveniencia/aproveite-seu-volvo/recalls	*
/br/conveniencia/aproveite-o-seu-volvo/servico-e-reparos	/br/conveniencia/aproveite-seu-volvo/servico-reparos	*
/br/conveniencia/aproveite-o-seu-volvo/volvo-personal-service	/br/conveniencia/aproveite-seu-volvo/vps	*
/br/conveniencia/aproveite-seu-volvo/carros-blindados	/br/proprietario/explorar/carros-blindados	*
/br/conveniencia/aproveite-seu-volvo/garantia	/br/proprietario/explorar/garantia	*
/br/conveniencia/aproveite-seu-volvo/plano-revisao	/br/proprietario/servico-manutencao/plano-revisao	*
/br/conveniencia/aproveite-seu-volvo/recalls	/br/proprietario/explorar/recalls	*
/br/conveniencia/aproveite-seu-volvo/servico-reparos	/br/proprietario/servico-manutencao/servico-reparos	*
/br/conveniencia/aproveite-seu-volvo/vps	/br/proprietario/servico-manutencao/vps	*
/br/conveniencia/design/agende-um-test-drive	/br/conveniencia/idealize-seu-volvo/agende-test-drive	*
/br/conveniencia/design/encontre-uma-concessionaria	/br/conveniencia/idealize-seu-volvo/concessionarias	*
/br/conveniencia/idealize-o-seu-volvo/agende-um-test-drive	/br/conveniencia/idealize-seu-volvo/agende-test-drive	*
/br/conveniencia/idealize-o-seu-volvo/encontre-uma-concession%C3%A1ria	/br/conveniencia/idealize-seu-volvo/concessionarias	*
/br/conveniencia/idealize-o-seu-volvo/servicos-financeiros/fale-conosco	/br/conveniencia/idealize-seu-volvo/servicos-financeiros/fale-conosco	*
/br/conveniencia/idealize-seu-volvo/agende-test-drive	/br/comprar/conheca-seu-volvo/agende-test-drive	*
/br/conveniencia/idealize-seu-volvo/concessionarias	/br/concessionarias	*
/br/conveniencia/idealize-seu-volvo/servicos-financeiros	/br/comprar/financas/servicos-financeiros	*
/br/conveniencia/idealize-seu-volvo/servicos-financeiros/duvidas-frequentes	/br/comprar/financas/servicos-financeiros/duvidas-frequentes	*
/br/conveniencia/idealize-seu-volvo/servicos-financeiros/fale-conosco	/br/comprar/financas/servicos-financeiros/fale-conosco	*
/br/conveniencia/idealize-seu-volvo/servicos-financeiros/financiamento-cdc	/br/comprar/financas/servicos-financeiros/financiamento-cdc	*
/jp/cp/1year-monitor2018asa/form	/jp/news-campaign	*
/jp/cp/1year-monitor2018p/form	/jp/news-campaign	*
/jp/cp/service2019	/jp/own/maintenance/maintenance/vehicle-inspection	*
/us/cpo	/us/shopping-tools/shop/certified-pre-owned	*
/be/customerservice-actie	/nl-be/naverkoop/uw-volvo/onderhoud-en-reparatie	*
/be/customerservice-action	/nl-be/naverkoop/uw-volvo/onderhoud-en-reparatie	*
/cz/customsearch/b2c-tdr-car-configurator	/cz/test-drive-booking	*
/se/dack	/se/dack/sommardack	*
/de/das-schwedische-suv	/de/modelle/neuwagen/xc60/das-schwedische-suv	*
/uk/data	/uk/Footer/Information-Notice/01	*
/intl/datarequest	/intl/footer/contact-us/subject-request	*
/jp/day	/jp/own/enjoy/day	*
/jp/news-campaign  https://jp.volvocars.com/jp/news-campaign	*
/jp/cp/1day-monitor-lp  https://jp.volvocars.com/jp/cp/monitor/	*
/jp/why-volvo/human-innovation/future-of-driving/safety/child-safety/child-seat  https://www.volvocars.com/jp/buy/sales/accessories	*
/jp/cp/2days-monitor  https://jp.volvocars.com/jp/cp/monitor/	*
/jp/cp/phevcp  https://jp.volvocars.com/jp/cp/phevcp	*
/uk/dc/accessories	/uk/buy/finance-sales/accessories/	*
/be/de-nieuwe-XC90	/nl-be/modellen/gamma/XC90	*
/be/de-nieuwe-xc40	/nl-be/modellen/gamma/xc40	*
/nl/dealer	/nl/dealers/autodealers  *
/uk/dealerservicecharter	/uk/own/maintenance/service-and-maintenance/volvo-service-promise	*
/be/denieuweXC60	/nl-be/modellen/gamma/xc60	*
/dk/denmark/oplev-volvo/amanda-bergman	/dk/oplev-volvo/amanda-bergman	*
/dk/denmark/oplev-volvo/appreciating-xc90	/dk/oplev-volvo/appreciating-xc90	*
/dk/denmark/oplev-volvo/autonomous-for-the-people	/dk/oplev-volvo/autonomous-for-the-people	*
/dk/denmark/oplev-volvo/a-volvo-is-for-life	/dk/oplev-volvo/a-volvo-is-for-life	*
/dk/denmark/oplev-volvo/bowers-and-wilkins	/dk/oplev-volvo/bowers-and-wilkins	*
/dk/denmark/oplev-volvo/bridge-of-weir	/dk/oplev-volvo/bridge-of-weir	*
/dk/denmark/oplev-volvo/car-play	/dk/oplev-volvo/car-play	*
/dk/denmark/oplev-volvo/chicago	/dk/oplev-volvo/chicago	*
/dk/denmark/oplev-volvo/cleanzone	/dk/oplev-volvo/cleanzone	*
/dk/denmark/oplev-volvo/connecting-with-the-xc90	/dk/oplev-volvo/connecting-with-the-xc90	*
/dk/denmark/oplev-volvo/connectivity-in-berlin	/dk/oplev-volvo/connectivity-in-berlin	*
/dk/denmark/oplev-volvo/crafted-by-sweden	/dk/oplev-volvo/crafted-by-sweden	*
/dk/denmark/oplev-volvo/crystal-clear-thinking	/dk/oplev-volvo/crystal-clear-thinking	*
/dk/denmark/oplev-volvo/destination-wellbeing	/dk/oplev-volvo/destination-wellbeing	*
/dk/denmark/oplev-volvo/discover-denmark-by-bike	/dk/oplev-volvo/discover-denmark-by-bike	*
/dk/denmark/oplev-volvo/exploring-norway-in-v60cc	/dk/oplev-volvo/exploring-norway-in-v60cc	*
/dk/denmark/oplev-volvo/forward-thinking	/dk/oplev-volvo/forward-thinking	*
/dk/denmark/oplev-volvo/forward-vision	/dk/oplev-volvo/forward-vision	*
/dk/denmark/oplev-volvo/gota-canal	/dk/oplev-volvo/gota-canal	*
/dk/denmark/oplev-volvo/innovation-team	/dk/oplev-volvo/innovation-team	*
/dk/denmark/oplev-volvo/in-search-of-a-happy-place	/dk/oplev-volvo/in-search-of-a-happy-place	*
/dk/denmark/oplev-volvo/living-with-the-xc90	/dk/oplev-volvo/living-with-the-xc90	*
/dk/denmark/oplev-volvo/lobster-fishing-in-sweden	/dk/oplev-volvo/lobster-fishing-in-sweden	*
/dk/denmark/oplev-volvo/luxury-for-little-travellers	/dk/oplev-volvo/luxury-for-little-travellers	*
/dk/denmark/oplev-volvo/made-by-sweden	/dk/oplev-volvo/made-by-sweden	*
/dk/denmark/oplev-volvo/muddus	/dk/oplev-volvo/muddus	*
/dk/denmark/oplev-volvo/naimakka	/dk/oplev-volvo/naimakka	*
/dk/denmark/oplev-volvo/nyc-sleep	/dk/oplev-volvo/nyc-sleep	*
/dk/denmark/oplev-volvo/our-window-to-the-world	/dk/oplev-volvo/our-window-to-the-world	*
/dk/denmark/oplev-volvo/ownership-and-in-car-delivery	/dk/oplev-volvo/ownership-and-in-car-delivery	*
/dk/denmark/oplev-volvo/sabine-fleiss	/dk/oplev-volvo/sabine-fleiss	*
/dk/denmark/oplev-volvo/sjoo-sandstrom	/dk/oplev-volvo/sjoo-sandstrom	*
/dk/denmark/oplev-volvo/skiing-in-sweden	/dk/oplev-volvo/skiing-in-sweden	*
/dk/denmark/oplev-volvo/smart-city-driving	/dk/oplev-volvo/smart-city-driving	*
/dk/denmark/oplev-volvo/the-beauty-of-simplicity	/dk/oplev-volvo/the-beauty-of-simplicity	*
/dk/denmark/oplev-volvo/the-scandinavian-sanctuary	/dk/oplev-volvo/the-scandinavian-sanctuary	*
/dk/denmark/oplev-volvo/the-swedish-pioneers	/dk/oplev-volvo/the-swedish-pioneers	*
/dk/denmark/oplev-volvo/time	/dk/oplev-volvo/time	*
/dk/denmark/oplev-volvo/tromso	/dk/oplev-volvo/tromso	*
/dk/denmark/oplev-volvo/unpack-and-unwind	/dk/oplev-volvo/unpack-and-unwind	*
/dk/denmark/oplev-volvo/validation-team	/dk/oplev-volvo/validation-team	*
/dk/denmark/oplev-volvo/volvo-on-call	/dk/oplev-volvo/volvo-on-call	*
/dk/denmark/oplev-volvo/where-every-voice-is-heard	/dk/oplev-volvo/where-every-voice-is-heard	*
/ro/despre-volvo/compania-noastra/mostenirea-noastra/o-traditie-de-inovatie	/ro/Despre-Volvo/Inovatie-Umana/Siguranta/Safety-heritage	*
/ro/despre-volvo/inovatie-umana/conectivitate/intellisafe-assist	/ro/despre-volvo/inovatie-umana/siguranta	*
/ro/despre-volvo/inovatie-umana/siguranta/intellisafe-standard	/ro/Despre-Volvo/Inovatie-Umana/Siguranta	*
/ro/despre-volvo/inovatie-umana/siguranta/intellisafe-surround	/ro/Despre-Volvo/Inovatie-Umana/Siguranta	*
/ro/despre-volvo/inovatie-umana/siguranta/masini-sigure-pentru-toti	/ro/Despre-Volvo/Inovatie-Umana/Siguranta	*
/ro/despre-volvo/inovatie-umana/viitorul-sofatului/motorizari	/ro/Despre-Volvo/Inovatie-Umana/Electrification	*
/ro/despre-volvo/inovatie-umana/viitorul-sofatului/motorizari/hibride-usoare	/ro/Despre-Volvo/Inovatie-Umana/Electrification/Mild-hybrids	*
/ro/despre-volvo/inovatie-umana/viitorul-sofatului/motorizari/masini-hibrid	/ro/Despre-Volvo/Inovatie-Umana/Electrification	*
/ro/despre-volvo/inovatie-umana/viitorul-sofatului/motorizari/motoare-cu-combustie	/ro/Despre-Volvo/Inovatie-Umana/Electrification	*
/ro/despre-volvo/inovatie-umana/viitorul-sofatului/motorizari/plug-in-hybrids	/ro/Despre-Volvo/Inovatie-Umana/Electrification/Plug-in-hybrids	*
/cz/deti	/cz/pro-uzivatele/uzivejte-si/detske-sedacky	*
/ch/digitalkey	/de-ch/Redirects/Digital-key	*
/fr-BE/diplo-sales	/fr-BE/acheter/services-volvo/diplomats-expats-military	*
/nl-BE/diplo-sales	/nl-BE/kopen/volvo-diensten/diplomats-expats-military	*
/lu/diplo-sales	/fr-be/acheter/services-volvo/diplomats-expats-military	*
/diplomat/diplomat1/shopping-tools/diplomat-offers	/intl/buy/purchase/diplomat	*
/diplomat/diplomat1/shopping-tools/diplomat-quote	/intl/buy/purchase/diplomat	*
/diplomat/diplomat1/shopping-tools/test-drive	/intl/buy/purchase/diplomat	*
/diplomat/diplomat1/the-diplomat-program/delivery-options	/intl/buy/purchase/diplomat	*
/diplomat/diplomat1/the-diplomat-program/delivery-options/factory-delivery	/intl/buy/purchase/diplomat	*
/diplomat/diplomat1/the-diplomat-program/delivery-options/home-shipment	/intl/buy/purchase/diplomat	*
/diplomat/diplomat1/the-diplomat-program/global-warranty	/intl/buy/purchase/diplomat	*
/diplomat/diplomat1/the-diplomat-program/your-diplomat-benefits	/intl/buy/purchase/diplomat	*
/fr-be/diplomatsales	/fr-be/diplomatsummerdeals	*
/fr-BE/diplomatsummerdeals	/fr-BE/acheter/services-volvo/diplomats-expats-military	*
/nl-BE/diplomatsummerdeals	/nl-BE/kopen/volvo-diensten/diplomats-expats-military	*
/lu/diplomatsummerdeals	/fr-be/acheter/services-volvo/diplomats-expats-military	*
/ie/discover-s90	/ie/cars/new-models/s90	*
/ie/discover-v40	/ie/cars/new-models/v40	*
/ie/discover-v60	/ie/cars/new-models/v60	*
/in/discover-volvo/human-innovation/future-of-driving/propulsion	/in/Why-Volvo/Human-Innovation/Electrification	*
/in/discover-volvo/human-innovation/future-of-driving/propulsion/combustion-engines	/in/Why-Volvo/Human-Innovation/Electrification	*
/in/discover-volvo/human-innovation/future-of-driving/propulsion/electric-cars	/in/Why-Volvo/Human-Innovation/Electrification/Pure-electric	*
/in/discover-volvo/human-innovation/future-of-driving/propulsion/mild-hybrids	/in/Why-Volvo/Human-Innovation/Electrification/Mild-hybrids	*
/in/discover-volvo/human-innovation/future-of-driving/propulsion/plug-in-hybrids	/in/Why-Volvo/Human-Innovation/Electrification/Plug-in-hybrids	*
/in/discover-volvo/human-innovation/future-of-driving/safety/cars-safe-for-all/selfie-for-safety	/in/Why-Volvo/Human-Innovation/Future-of-driving/Safety	*
/in/discover-volvo/human-innovation/future-of-driving/safety/intellisafe-assist	/in/Why-Volvo/Human-Innovation/Future-of-driving/Safety	*
/in/discover-volvo/human-innovation/future-of-driving/safety/intellisafe-standard	/in/Why-Volvo/Human-Innovation/Future-of-driving/Safety	*
/in/discover-volvo/human-innovation/future-of-driving/safety/intellisafe-surround	/in/Why-Volvo/Human-Innovation/Future-of-driving/Safety	*
/in/discover-volvo/human-innovation/propulsion	/in/Why-Volvo/Human-Innovation/Electrification	*
/in/discover-volvo/our-company/heritage/innovations	/in/Why-Volvo/Human-Innovation/Future-of-driving/Safety/Safety-heritage	*
/es/discover-volvo/coches-sin-llave	/es/Discover-Volvo	*
/ie/discover-xc40	/ie/Cars/New-Models/XC40	*
/ie/discover-xc60	/ie/cars/new-models/new-xc60	*
/ie/discover-xc60-2017	/ie/cars/new-models/xc60	*
/ie/discover-xc90	/ie/Cars/New-Models/XC90	*
/be/distributeurs	/fr-be/acheter/votre-nouvelle-volvo/trouvez-votre-concessionnaire	*
/fr-be/distributeurs	/fr-be/acheter/votre-nouvelle-volvo/trouvez-votre-concessionnaire	*
/lu/distributeurs	/lu/acheter/votre-nouvelle-volvo/trouvez-votre-concessionnaire	*
/nl-be/dit-is-een-test	/nl-be/Modellen/Gamma/S60	*
/de/dolby	/de/Deutschland	*
/uk/drive	/uk/buy/test-drive-rp	*
/se/drive-e	/se/om-volvo/innovationer/drive-e	*
/uk/drivee	/uk/about/our-innovations/drive-e	*
/uk/eb	/uk/Buy/Research/Brochure-Pricelist/Retailer-eBrochure	*
/en-eg/egypt/dct%20forms/book%20a%20test%20drive	/en-eg/Forms/tdr-en	*
/de/ehfk	/de/volvo/mehr-volvo/ein-herz-fuer-kinder	*
/uk/electrifyingbusiness	/uk/cars/business-sales/vq	*
/nl/elektrificatie	/nl/Ontdek-Volvo/Innovaties/Toekomst-van-mobiliteit/Elektrificatie	*
/cz/elektrina-zdarma	/cz/proc-volvo/inovace/elektrifikovana-vozidla/plug-in-hybridni-vozidla/nahrada-elektriny-na-jeden-rok-provozu	*
/uk/emergency-services	/uk/Buy/Finance-Sales/Special-Sales/Emergency-Services	*
/uk/emergencyservices	/uk/buy/sales/specialist-sales/emergency-services	*
/uk/emergencyvehicles	/uk/buy/sales/specialist-sales/emergency-services	*
/es/empresas/vehiculos-de-empresa/coches-de-empresa	/es/servicios/investigacion/empresa/coches-de-empresa	*
/es/empresas/vehiculos-de-empresa/gama-volvo-empresas	/es/servicios/investigacion/empresa/vehiculos-de-empresa	*
/es/empresas/vehiculos-de-empresa/noticias-volvo-empresas	/es/servicios/investigacion/empresa/noticias-corporativas	*
/es/empresas/vehiculos-de-empresa/valores-de-volvo	/es/servicios/investigacion/empresa/valores-corporativos	*
/se/erbjudande	/se/erbjudanden	*
/de/erleben	/de/volvo/mehr-volvo/volvoforum	*
/be/essai	/fr-be/vente/configurez-et-achetez/reservez-un-essai	*
/lu/essai	/lu/vente/configurez-et-achetez/reservez-un-essai	*
/language-selector/europe/belgium	/be	*
/language-selector/europe/estonia	/ee	*
/language-selector/europe/latvia	/lv	*
/language-selector/europe/switzerland	/ch	*
/language-selector/europe/ukraine	/ua	*
/be/eva	/nl-be/waarom-volvo/innovaties/future-of-driving/veiligheid/eva	*
/nl-be/eva	/nl-be/waarom-volvo/innovaties/future-of-driving/veiligheid/eva	*
/cz/eva	/cz/proc-volvo/inovace/budoucnost-rizeni/bezpecnost/vozy-bezpecne-pro-vsechny	*
/de/eva	/de/Volvo/Innovationen/Sicherheit/EVA	*
/hk/eva	/hk/why-volvo/human-innovation/future-of-driving/safety/cars-safe-for-all	*
/hu/eva	/hu/About/Innovacio/A-vezetes-jovoje/Biztonsag/Mindenki-szamara-biztonsagos-autok	*
/in/eva	/in/why-volvo/human-innovation/future-of-driving/safety/cars-safe-for-all	*
/ie/eva	/ie/About/Human-Innovation/Future-of-driving/Safety/Cars-safe-for-all	*
/it/eva	/it/mondo-volvo/innovazioni/il-futuro-della-guida/sicurezza/auto-sicure-per-tutti	*
/jp/eva	/jp/why-volvo/human-innovation/future-of-driving/safety/cars-safe-for-all	*
/lu/eva	/lu/pourquoi-volvo/innovation-humaine/avenir-de-la-conduite/securite/pour-tout-le-monde	*
/nl/eva	/nl/v/car-safety/eva-initiative-cars-equally-safe  *
/ru/eva	/ru/Why-Volvo/Human-Innovations/Future-of-driving/Safety/Cars-safe-for-all	*
/sg/eva	/sg/why-volvo/human-innovation/future-of-driving/safety/cars-safe-for-all	*
/ch/eva	/de-ch/Redirects/EVA	*
/uk/eva	/uk/About/Human-Innovation/Future-of-driving/Safety/Cars-safe-for-all	*
/us/eva	/us/about-volvo/human-innovation/future-of-driving/safety/cars-safe-for-all	*
/uk/events	/uk/about/humanmade/news	*
/ch/executive	/de-ch/Redirects/Executive	*
/ch/exhibition	/de-ch/Redirects/exhibition	*
/diplomat/expat/shopping-tools/find-a-dealer	/intl/buy/purchase/diplomat	*
/diplomat/expat/shopping-tools/quick-quote-expat	/intl/buy/purchase/diplomat	*
/diplomat/expat/the-expat-program/the-expat-program	/intl/buy/purchase/diplomat	*
/diplomat/expat/the-expat-program/the-expat-program/canadian-citizens	/intl/buy/purchase/diplomat	*
/diplomat/expat/the-expat-program/the-expat-program/european-citizens	/intl/buy/purchase/diplomat	*
/diplomat/expat/the-expat-program/the-expat-program/expats-in-switzerland	/intl/buy/purchase/diplomat	*
/diplomat/expat/the-expat-program/the-expat-program/other-nationalities	/intl/buy/purchase/diplomat	*
/diplomat/expat/the-expat-program/the-expat-program/uk-citiziens	/intl/buy/purchase/diplomat	*
/diplomat/expat/the-expat-program/the-expat-program/us-citizens	/intl/buy/purchase/diplomat	*
/br/experience	/br/sobre/nossa-empresa/volvo-cars-experience	*
/by/explore/concept-cars/concept-estate/pages	/by/cars/concept-cars/concept-estate	*
/by/explore/concept-cars/concept-xc-coupe/pages	/by/cars/concept-cars/concept-xc-coupe	*
/br/explore/novo-volvo	/br/modelos-volvo/modelos	*
/ee/explore/concept-cars/concept-coupe/pages	/et-ee/autod/ideeautod/concept-coupe	*
/ee/explore/concept-cars/concept-estate/pages	/et-ee/autod/ideeautod/concept-estate	*
/ee/explore/concept-cars/concept-xc-coupe/pages	/et-ee/autod/ideeautod/concept-xc-coupe	*
/lu/explore/volvo-ocean-race/human-stories/pages	/lu/a-propos-de-volvo/nos-histoires/volvo-ocean-race	*
/es/explore/volvo-ocean-race/human-stories/pages	/es/acerca-de-volvo/historias-y-eventos/volvo-ocean-race	*
/de-CH/explore/concept-cars/concept-coupe/pages	/de-CH/modelle/concept-cars/concept-coupe	*
/de-CH/explore/concept-cars/concept-estate/pages	/de-CH/modelle/concept-cars/concept-estate	*
/de-CH/explore/concept-cars/concept-xc-coupe/pages	/de-CH/modelle/concept-cars/concept-xc-coupe	*
/it-CH/explore/concept-cars/concept-coupe/pages	/it-CH/modelli/concept-cars/concept-coupe	*
/it-CH/explore/concept-cars/concept-estate/pages	/it-CH/modelli/concept-cars/concept-estate	*
/it-CH/explore/concept-cars/concept-xc-coupe/pages	/it-CH/modelli/concept-cars/concept-xc-coupe	*
/it-CH/explore/xc60_plug_in_hybrid	/it-CH/nos-modelli/modelli/volvo-xc60	*
/be/extendedprotection	/be	*
/lu/extendedprotection	/lu/acheter/services-volvo/extended-services/extended-warranty	*
/be/extendedprotection-fr	/fr-be/acheter/services-volvo/extended-services/extended-warranty	*
/be/extendedprotection-nl	/nl-be/kopen/volvo-diensten/extended-services/extended-warranty	*
/lu/extendedservices	/lu/acheter/services-volvo/extended-services	*
/be/extendedservices-fr	/fr-be/acheter/services-volvo/extended-services	*
/be/extendedservices-nl	/nl-be/kopen/volvo-diensten/extended-services	*
/be/fabrieksbezoek	/nl-be/waarom-volvo/de-wereld-van-volvo/volvo-car-gent	*
/de/factory-delivery-experience	/de/Beratung-und-Kauf/Ueberblick/Factory-Delivery-Experience	*
/ch/fantasticstops	/de-ch/Redirects/FantasticStops	*
/ch/fantastiskastopp	/de-ch/Redirects/FantasticStops	*
/de/faszination-volvo/unsere-innovationen/Drive-E	/de/volvo/innovationen/drive-e	*
/de/faszination-volvo/unsere-innovationen/intellisafe	/de/volvo/innovationen/intellisafe	*
/de/faszination-volvo/unsere-innovationen/Sensus-Connect	/de/zubehoer-und-services/apps-und-bedienung/sensus-connect	*
/ch/finance	/de-ch/Redirects/finance	*
/uk/financebusiness	/uk/cars/business-sales/finance	*
/lu/financement	/lu/acheter/services-volvo/financement-et-leasing	*
/ch/financial-services	/de-ch/Redirects/Volvo-Car-Financial-Services	*
/lu/financialservices	/lu/acheter/services-volvo/financement-et-leasing	*
/be/financialservices-fr	/fr-be/acheter/services-volvo/financement-et-leasing	*
/be/financialservices-nl	/nl-be/kopen/volvo-diensten/financiering-en-leasing	*
/de/FinancialServices/Apply /de/Deutschland *
/nl/financieren	/nl/Lease-en-Financiering/Producten/Financieren	*
/cz/financovani	/cz/sluzby/vyber-a-koupe/financovani	*
/se/finansiering	/se/kop/finansiering-och-tjanster/privat	*
/de/finanzierung	/de/Beratung-und-Kauf/Unsere-Leistungen/Financial-Services/Finanzprodukte	*
/nl/declaratie	/nl/l/mijn-volvo/assistance/  *
/ie/findadealer	/ie/find-a-dealer	*
/uk/findadealer	/uk/find-a-dealer	*
/ie/findaretailer	/ie/Find-A-Dealer	*
/no/finnforhandler	/no/buy/order-and-buy/find-a-dealer	*
/de/firstedition	/de/modelle/neuwagen/der-neue-xc90	*
/de/firstedition%20ihren%20Volvo%20XC90	/de/modelle/neuwagen/xc90	*
/de/fixpreise	/de/zubehoer-und-services/zubehoer-und-services/serviceleistungen/fixpreisangebote	*
/ch/fleet	/de-ch/Redirects/fleet	*
/cz/fleet	/cz/vozy/fleetovy-prodej	*
/de/fleet	/de/Beratung-und-Kauf/Ueberblick/Business	*
/uk/fleet	/uk/cars/business-sales	*
/us/fleet	/us/shopping-tools/explore/fleet-sales	*
/uk/fleethub	/uk/cars/business-sales/fleet-hub	*
/uk/fleetnews	/uk/cars/business-sales/news	*
/uk/fleetsales	/uk/cars/business-sales	*
/de/flexplusservice	/de/zubehoer-und-services/zubehoer-und-services/serviceleistungen/fixpreisangebote	*
/de/footer/datenschutzhinweis  /de/legal/privacy/privacy-customer-care	*
/uk/forbusiness	/uk/cars/business-sales	*
/de/forum	/de/volvo/mehr-volvo/volvoforum	*
/be/fr/a-million-more	/fr-be/v/car-safety/a-million-more	*
/be/fr/eva	/fr-be/pourquoi-volvo/innovation-humaine/avenir-de-la-conduite/securite/pour-tout-le-monde	*
/be/fr/la-nouvelle-xc40	/fr-be/v/cars/xc40-hybrid	*
/be/fr/nouvelleS90	/fr-be/v/cars/s90-hybrid	*
/be/fr/repaynature	/fr-be/pourquoi-volvo/innovation-humaine/avenir-de-la-conduite/propulsion/avenir-electrique	*
/de/fruehling-fuer-die-sinne	/de/zubehoer-und-services/services/serviceleistungen/fruehling-fuer-die-sinne	*
/de/fruehling08/de	/de/Deutschland	*
/ch/full-service-leasing	/de-ch/Redirects/Volvo-Car-Full-Service-Leasing	*
/nl/fulldaydrive	/nl/ontdek/samenstellen/proefrit-boeken	*
/nl/fulldaytestdrive	/nl/ontdek/samenstellen/proefrit-boeken	*
/be/futureofdriving-nl	/nl-be/modellen/futureofdriving	*
/intl/gdpr/privacy	/intl/Footer/GDPR%20Privacy%20CXO	*
/ie/genuineparts	/ie/own/maintenance/service-promise	*
/uk/getintouch	/uk/cars/business-sales/contact	*
/de/golfaward	/de/Deutschland	*
/ch/gpc	/de-ch/redirects/general-policy-conditions	*
/nl/gratis-laadstroom	/nl/Ontdek-Volvo/Innovaties/Toekomst-van-mobiliteit/Elektrificatie/Plug-in-hybrids/Gratis-laadstroom	*
/de/grosskunden	/de/beratung-und-kauf/ueberblick/geschaeftswagen	*
/se/grundenbois	/se/volvomagasin/artikel/elin-rubensson-tranade-grunden-bois	*
/de/haendler	/de/beratung-und-kauf/mehr-erleben/haendlersuche	*
/de/haendler-finden	/de/Beratung-und-Kauf/Mehr-erleben/Haendlersuche	*
/de/haendlersuche	/de/Beratung-und-Kauf/Mehr-erleben/Haendlersuche	*
/nl/harman-kardon	/nl/ontdek/in-de-spotlight/harman-kardon	*
/be/herfstcheck	/nl-be/naverkoop/uw-volvo/onderhoud-en-reparatie/seizoenscheck	*
/de/historische-modelle	/de/volvo/unser-unternehmen/markentradition/historische-modelle	*
/de/hololens	/de/volvo/mehr-volvo/der-mensch-im-mittelpunkt/unsere-zukunftsvision/hololens	*
/uk/hub	/uk/cars/model-lineup	*
/uk/humanmade	/uk/about/humanmade/discover-volvo/defiant-pioneers	*
/uk/humanmadestories	/uk/about/humanmade/discover-volvo/defiant-pioneers	*
/fi/huollonhintalaskuri	/fi/palvelut/huolto-ja-yllapito/huollon-hintalaskuri	*
/se/hvo100	/se/volvomagasin/artikel/allt-om-hvo100	*
/ch/hybrid	/de-ch/Redirects/hybrid	*
/uk/hybrid	/uk/cars/new-models/v60/variants	*
/uk/hybridfleet	/uk/Cars/Business-Sales/hybridfleet	*
/uk/hybridforbusiness	/uk/cars/business-sales/hybrid-for-business	*
/fi/hybridiautot	/fi/v/cars/recharge	*
/uk/hybrids	/uk/about/our-innovations/plugin-hybrids	*
/ch/icd	/de-ch/Redirects/incardelivery	*
/de/im-einsatz	/de/Beratung-und-Kauf/Ueberblick/Business/Einsatzfahrzeuge	*
/de/impressum	/de/footer/impressum	*
/ch/incardelivery	/de-ch/Redirects/incardelivery	*
/se/inclusive	/se/agande/agande/privatleasing	*
/de/infomaterial	/de/Beratung-und-Kauf/Mehr-erleben/Preislisten	*
/be/innovaties	/nl-be/waarom-volvo/innovaties	*
/nl/innovaties	/nl/over-volvo/onze-innovaties/drive-e	*
/ch/innovationen	/de-ch/ueber-volvo/volvo-inside/Innovationen	*
/be/innovations	/fr-be/pourquoi-volvo/innovation-humaine	*
/lu/innovations	/lu/pourquoi-volvo/innovation-humaine	*
/uk/innovations	/uk/about/our-stories/human-innovations	*
/se/insidan	/se/bilar/modeller/s90/insidan	*
/nl/instructieboekje	/nl/service/uw-volvo/support	*
/ch/insurance	/de-ch/Redirects/Volvo-Car-Insurance	*
/lu/insurance	/lu/acheter/services-volvo/extended-services	*
/uk/insurance	/uk/buy/sales/volvo-car-insurance	*
/be/insurance-fr	/fr-be/acheter/services-volvo/assurance-omnium	*
/be/insurance-nl	/nl-be/kopen/volvo-diensten/omniumverzekeringen	*
/be/intellisafe	/be	*
/lu/intellisafe	/lu/pourquoi-volvo/innovation-humaine/avenir-de-la-conduite/securite/intellisafe-standard	*
/uk/intellisafe	/uk/about/our-innovations/intellisafe	*
/be/intellisafe-fr	/fr-be/pourquoi-volvo/innovation-humaine/avenir-de-la-conduite/securite/intellisafe-standard	*
/be/intellisafe-nl	/nl-be/waarom-volvo/innovaties/future-of-driving/veiligheid/intellisafe-standaard	*
/au/international/about/our-innovation-brands/intellisafe/autopilot	/au/about/innovations/intellisafe	*
/br/international/cars/new-models/xc90	/br/modelos-volvo/novos-modelos/o-novo-xc90	*
/de/international/discover-volvo/stories-by-topic	/de/volvo/unser-unternehmen/stories-und-inspiration	*
/intl/international/about/our-innovation-brands/intellisafe/intellisafe-autopilot	/intl/about/our-innovation-brands/intellisafe/autonomous-driving	*
/be/international	/nl-be/kopen/uw-nieuwe-volvo/volvo-verdelers	*
/be/interventiondays-fr	/fr-be/acheter/services-volvo/interventiondays	*
/be/interventiondays-nl	/nl-be/kopen/volvo-diensten/interventiondays	*
/nl/jaarbeurt	/nl/service/onderhoud-en-reparatie/onderhoud	*
/se/jobba-pa-volvo-cars	/se/OM-VOLVO/Foretaget/Karriar	*
/be/jpc	/fr-be/acheter/votre-nouvelle-volvo/distributeurs	*
/be/juridischeinfo	/nl-be/footer/juridische-info	*
/cz/kampane/odklad-splatek-o-6-mesicu	/cz/kampane/nabidky-financovani	*
/de/karriere/handel	/de/Volvo/Unser-Unternehmen/Karriere/Handel	*
/de/karriere	/de/volvo/unser-unternehmen/karriere	*
/de/kindersicherheit	/de/Volvo/Innovationen/Sicherheit/Kindersicherheit	*
/be/kinderzitjes	/nl-be/accessoires/veiligheid-en-zekerheid/kinderzitjes	*
/us/kingofsweden	/us/shopping-tools/explore/events/king-of-sweden-day-sale	*
/be/kitsderoues	/fr-be/accessoires/roues-et-jantes	*
/lu/kitsderoues	/lu/accessoires/roues-et-jantes	*
/de/klubb90	/de/beratung-und-kauf/mehr-erleben/klubb90	*
/be/knoks	/nl-be/kopen/uw-nieuwe-volvo/volvo-verdelers	*
/fi/koeajo	/fi/palvelut/lisapalvelut/varaa-koeajo	*
/cz/koncepty	/cz/vozy/koncepcni-vozy	*


/sk/kupit/obchod/akciove-ponuky  /sk/l/Offers/  *
/sk/kupit/vyskum/rezervovat-skusobnu-jazdu	/sk/Forms/tdr	*
/lu/la-nouvelle-XC90	/lu/modeles/gamme/xc90	*
/be/la-nouvelle-xc40	/fr-be/modeles/gamme/xc40	*
/lu/la-nouvelle-xc40	/lu/modeles/gamme/xc40	*
/be/lanouvelleXC60	/fr-be/modeles/gamme/xc60	*
/lu/lanouvelleXC60	/lu/modeles/gamme/xc60	*
/uk/leasing/affinity-offers	/uk/cars/business-sales	*
/uk/leasing/affinity-offers/employee-offers	/uk/cars/business-sales	*
/uk/leasing/affinity-offers/member-offers	/uk/cars/business-sales	*
/uk/leasing/smr-data  /<market>/l/leasing/smr-data/  *
/de/leasing	/de/Beratung-und-Kauf/Unsere-Leistungen/Financial-Services/Leasingprodukte	*
/se/leasing	/se/agande/agande/volvo-business/business-lease	*
/be/lentecheck	/nl-be/naverkoop/uw-volvo/onderhoud-en-reparatie/seizoenscheck	*
/uk/lifepaint	/uk/about/our-innovations/lifepaint	*
/ch/lifestyle	/de-ch/Redirects/Volvo-Lifestyle	*
/de/lifetime	/de/Zubehoer-und-Services/Services/Serviceleistungen/Lebenslange-Ersatzteilgarantie	*
/ie/livechatnotice	/uk/footer/information-notice/14	*
/uk/livechatnotice	/uk/Footer/Information-Notice/14	*
/us/livery	/us/shopping-tools/additional-choices/fleet-sales/livery	*
/de/lobenstein	/de/Deutschland	*
/uk/lostinforks	/uk/about/humanmade/discover-volvo	*
/ch/magazine	/de-ch/redirects/magazine	*
/se/manadenserbjudande	/se/aga/service/service-och-underhall/volvobutiken/manadens-erbjudanden	*
/nl/mapcare	/nl/service/uw-volvo/support	*
/cz/mapupdate	/cz/support/topics/maps-and-navigation	*
/nl/mapupdate	/nl/service/uw-volvo/support	*
/uk/mapupdate	/uk/own/enjoy/navigation-maps	*
/ro/masini/modele-noi/s60	/ro/cars/new-models/s60	*
/ro/masini/modele-noi/s60-cross-country	/ro/cars/new-models/s60-cross-country	*
/ro/masini/modele-noi/s90	/ro/cars/new-models/s90	*
/ro/masini/modele-noi/v60	/ro/cars/new-models/v60	*
/ro/masini/modele-noi/v60-cross-country	/ro/cars/new-models/v60-cross-country	*
/ro/masini/modele-noi/xc60	/ro/cars/new-models/xc60	*
/nl/merchandise	/nl/service/uw-volvo/accessoires#merchandise	*
/language-selector/middle-east-africa/ae	/ae	*
/uk/mobilewash	/uk/About/Human-Innovation/Future-of-driving/Connectivity/Services/Mobile-Wash	*
/de/mobilitaetsrate	/de/beratung-und-kauf/ueberblick/mobilitaetsrate	*
/nl/models/c30	/nl/modellen/model/s60	*
/ro/models/s60	/ro/cars/new-models/s60	*
/ro/models/s60/gallery	/ro/cars/new-models/s60	*
/ro/models/s60/which/Variant	/ro/cars/new-models/s60	*
/uk/models/XC70	/uk/cars/new-models/xc60	*
/uk/models/s80	/uk/cars/new-models/s90	*
/uk/models/v50	/uk/cars/new-models/v60	*
/de/modelsMY07/c70	/de/Deutschland	*
/de/modelsMY07/v70	/de/Deutschland	*
/uk/motability	/uk/buy/sales/motability	*
/uk/motorinsurance	/uk/buy/sales/volvo-car-insurance	*
/us/mybagsarepacked	/us/buy/sales/overseas-delivery	*
/uk/mynewS90	/uk/cars/new-models/s90/volvos90	*
/uk/mynewV40	/uk/cars/new-models/v40/volvov40	*
/uk/mynewV60	/uk/cars/new-models/v60/volvov60	*
/uk/mynewV90	/uk/cars/new-models/v90/volvov90	*
/uk/mynewXC40	/uk/Cars/New-Models/XC40/VolvoXC40	*
/uk/mynewXC90	/uk/cars/new-models/xc90/volvoXc90	*
/uk/mynewxc60	/uk/cars/new-models/new-xc60/volvoxc60	*
/uk/myorder	/uk/own/owner-info/my-volvo/order-tracking	*
/at/myvolvo	/at/info-Sign-In	*
/de/myvolvo	/de/info/sign-in	*
/fr-be/myvolvo	/fr-be/info/sign-in	*
/fr-ch/myvolvo	/fr-ch/info/sign-in	*
/it-ch/myvolvo	/it-ch/info/sign-in	*
/nl-be/myvolvo	/nl-be/info/sign-in	*
/us/myvolvo	/us/own/owner-info/myvolvo	*
/lu/myvolvomagazine	/lu/pourquoi-volvo/le-monde-de-volvo/my-volvo-magazine	*
/cz/nahrada-elektriny	/cz/proc-volvo/inovace/elektrifikovana-vozidla/plug-in-hybridni-vozidla/nahrada-elektriny-na-jeden-rok-provozu	*
/cz/najit-dealera	/cz/najit-prodejce	*
/de/naturtalente	/de/volvo/mehr-volvo/naturtalente	*
/de/naturtalente-erleben	/de/volvo/mehr-volvo/naturtalente	*
/nl/navigatie	/nl/service/uw-volvo/support	*
/de/neuers40	/de/Deutschland	*
/de/neunzig	/de/beratung-und-kauf/mehr-erleben/klubb90	*
/fr-be/new-v60-discovery-night	/fr-be/modeles/gamme/v60	*
/nl-be/new-v60-discovery-night	/nl-be/modellen/gamma/v60	*
/jp/news	/jp/news-campaign	*
/il/news-and-events/golf-may18-event	/il/news-and-events	*
/il/news-and-events/sales-event-jan19	/il/news-and-events	*
/il/news-and-events/volvo-xc-club/june-2017	/il/news-and-events/xc-club-june-2017	*
/il/news-and-events/volvo-xc-club/october-2017	/il/news-and-events/xc-club-october-2017	*
/il/news-and-events/when-did-volvo-get-so-cool	/il/news-and-events	*
/il/news-and-events/xc-club-june-2017	/il/news-and-events	*
/il/news-and-events/xc-club-october-2017	/il/news-and-events	*
/de/newsletter	/de/keep-me-updated	*
/be/nieuweS90	/nl-be/modellen/gamma/s90	*
/nl/nieuweXC90	/nl/modellen/model/xc90	*
/be/nieuwsbrief	/nl-be/verkoop/configureer-en-koop/nieuwsbrief	*
/uk/ninety	/uk/cars/new-models/ninety	*
/be/nl/a-million-more	/nl-be/v/car-safety/a-million-more	*
/be/nl/eva	/nl-be/waarom-volvo/innovaties/future-of-driving/veiligheid/voor-iedereen	*
/be/nl/jonas	/nl-be/over-volvo/de-wereld-van-volvo/ontdek-volvo/jonas-gerckens	*
/be/nl/nieuweS90	/nl-be/v/cars/s90-hybrid	*
/be/nl/repaynature	/nl-be/waarom-volvo/innovaties/future-of-driving/aandrijving/elektrische-toekomst	*
/be/nl/s60	/nl-be/v/cars/s60-hybrid	*
/be/nl/s60-classic	/nl-be/v/cars/s60-hybrid	*
/be/nl/s90	/nl-be/v/cars/s90-hybrid	*
/be/nl/v40	/nl-be/v/cars/wagon	*
/be/nl/v40cc	/nl-be/modellen/gamma/v40/uitrustingen/cross-country	*
/be/nl/v60	/nl-be/v/cars/v60-hybrid	*
/be/nl/v60-classic	/nl-be/v/cars/v60-hybrid	*
/be/nl/v90	/nl-be/v/cars/v90-hybrid	*
/be/nl/xc40	/nl-be/v/cars/xc40-hybrid	*
/be/nl/xc60	/nl-be/v/cars/xc60-hybrid	*
/be/nl/xc90	/nl-be/v/cars/xc90-hybrid	*
/au/nobel-media-partnership	/au/why-volvo/discover/partnerships	*
/ie/notifications	/ie/Own/Service-Maintenance/Recalls/Notifications	*
/uk/notifications	/uk/Own/Maintenance/Volvo-Warranty/Recalls/Notifications	*
/be/nouvelleS90	/fr-be/modeles/gamme/s90	*
/cz/nove-volvo-xc90	/cz/vozy/modely/volvo-xc90	*
/cz/novinky	/cz/o-nas/o-spolecnosti/novinky-a-udalosti	*
/se/numberten	/se/OM-VOLVO/Foretaget/Partnerskap/Svenska-Fotbollforbundet	*
/se/nya-volvo-v60	/se/BILAR/Modeller/V60	*
/se/nyas90	/se/bilar/modeller/s90/insidan	*
/se/nyavolvos90	/se/bilar/modeller/s90/insidan	*
/se/nyhetsbrev	/se/sidfot/nyhetsbrev	*
/cz/o-nas/o-spolecnosti/zazijte-volvo-cars	/visitor	*
/pl/o-nas/nasz-swiat/made-by-sweden	/pl/o-nas/swiat-volvo/made-by-sweden/	*
/pl/o-nas/nasz-swiat/made-by-sweden/child-safety	/pl/o-nas/swiat-volvo/made-by-sweden/child-safety	*
/pl/o-nas/nasz-swiat/made-by-sweden/child-safety/child-safety-by-volvo	/pl/o-nas/swiat-volvo/made-by-sweden/child-safety/child-safety-by-volvo	*
/pl/o-nas/nasze-innowacje/Drive-E	/pl/dlaczego-volvo/nasze-innowacje/przyszlosc-motoryzacji	*
/pl/o-nas/nasze-innowacje/IntelliSafe	/pl/dlaczego-volvo/nasze-innowacje/przyszlosc-motoryzacji	*
/pl/o-nas/nasze-innowacje/IntelliSafe/Autopilot	/pl/dlaczego-volvo/nasze-innowacje/przyszlosc-motoryzacji	*
/pl/o-nas/nasze-innowacje/IntelliSafe/C26	/pl/dlaczego-volvo/nasze-innowacje/przyszlosc-motoryzacji	*
/pl/o-nas/nasze-innowacje/Sensus	/pl/dlaczego-volvo/nasze-innowacje/przyszlosc-motoryzacji	*
/rs/o-volvou/nasa-kompanija/dozivite-volvo-cars	/visitor	*
/rs/o-volvou/nasa-kompanija/nasledje/inovacije	/rs/Zasto-Volvo/Inovacije/Bezbednost/Safety-heritage	*
/nl/occasions	/nl/l/aanschaf-en-lease/volvo-occasions/  *
/ch/ocean-race	/de-ch/Redirects/Ocean-Race	*
/be/oceanrace	/be	*
/se/oceanrace	/se/om-volvo/aktuella-handelser/sponsring-och-event	*
/us/offerdetails	/us/buy/shopping-tools/offers	*
/uk/omtanke	/uk/About/Our-Company/This-is-Volvo-Cars/Sustainability	*
/nl/onCall	/nl/ontdek/in-de-spotlight/volvo-on-call	*
/at/oncall	/at/service-und-zubehoer/ihr-volvo/volvo-on-call	*
/nl/onderhoud	/nl/service/onderhoud-en-reparatie/onderhoud	*
/nl/onderhoudsprijzen	/nl/service/onderhoud-en-reparatie/onderhoud/service-price-indicator	*
/nl/ontdek/in-de-spotlight/90th-anniversary-editions	/nl/Modellen/Model/XC90	*
/nl/ontdek/in-de-spotlight/smartphone-integratie	/nl/Ontdek-Volvo/Connectiviteit/Smartphone-integratie	*
/nl/ontdek/in-de-spotlight/volvo-on-call	/nl/Ontdek-Volvo/Connectiviteit/Volvo-On-Call	*
/nl/ontdek/in-de-spotlight/volvo-on-call/volvo-id	/nl/Ontdek-Volvo/Connectiviteit/Volvo-On-Call/Volvo-ID	*
/nl/ontdek/in-de-spotlight/yourfulldaytestdrive	/nl/ontdek/samenstellen/proefrit-boeken	*
/nl/ontdek/in-de-spotlight/yourfulldaytestdrive/reviews	/nl/ontdek/samenstellen/proefrit-boeken	*
/nl/ontdek/producten/finance	/nl/ontdek/producten/lease-en-finance	*
/nl/ontdek/producten/finance/bereken-maandtermijn	/nl/ontdek/producten/lease-en-finance	*
/nl/ontdek/producten/finance/vraag-financieringsofferte-aan	/nl/ontdek/producten/lease-en-finance	*
/nl/ontdek/producten/insurance	/nl/Lease-en-Financiering/Producten/Insurance	*
/nl/ontdek/producten/insurance/aanbiedingen	/nl/Lease-en-Financiering/Producten/Insurance/Aanbiedingen	*
/nl/ontdek/producten/insurance/bereken-premie	/nl/Lease-en-Financiering/Producten/Insurance/Bereken-Premie	*
/nl/ontdek/producten/insurance/disclaimer	/nl/Lease-en-Financiering/Producten/Insurance/Disclaimer	*
/nl/ontdek/producten/insurance/fraude	/nl/Lease-en-Financiering/Producten/Insurance/Fraude	*
/nl/ontdek/producten/insurance/privacy	/nl/Lease-en-Financiering/Producten/Insurance/Privacy	*
/nl/ontdek/producten/lease	/nl/ontdek/producten/lease-en-finance	*
/nl/ontdek/producten/lease-en-finance	/nl/Lease-en-Financiering/Producten/Financieren	*
/nl/ontdek/producten/lease/aanbiedingen	/nl/ontdek/producten/lease-en-finance	*
/nl/ontdek/producten/lease/informatie-en-documentatie	/nl/ontdek/producten/lease-en-finance	*
/nl/ontdek/producten/lease/offerte-aanvragen	/nl/ontdek/producten/lease-en-finance	*
/nl/ontdek/producten/prive	/nl/Lease-en-Financiering/Producten/Financieren	*
/nl/ontdek/producten/prive/aanbiedingen	/nl/Lease-en-Financiering/Producten/Financieren/Aanbiedingen	*
/nl/ontdek/producten/prive/bereken-maandtermijn	/nl/Lease-en-Financiering/Producten/Financieren/Bereken-Maandtermijn	*
/nl/ontdek/producten/prive/informatie-en-documentatie	/nl/ontdek/producten/lease-en-finance	*
/nl/ontdek/producten/prive/volvo-private-lease	/nl/Lease-en-Financiering/Producten/Financieren/Volvo-Private-Lease	*
/nl/ontdek/producten/zakelijk	/nl/Lease-en-Financiering/Producten/Zakelijk-lease	*
/nl/ontdek/samenstellen/brochure	/nl/Footer/Prijslijsten	*
/nl/ontdek/samenstellen/proefrit-boeken	/nl/Lease-en-Financiering/Orienteren/Proefrit-aanvragen	*
/nl/ontdek/samenstellen/vind-uw-dealer	/nl/Lease-en-Financiering/Dealer/Vind-uw-dealer	*
/nl/onze-historie	/nl/over-volvo/onze-organisatie/onze-historie	*
/at/ooe	/at/Volvo%20Partner%20Oberoesterreich	*
/uk/open-water	/uk/About/HumanMade/Discover-Volvo/Open-Water	*
/se/optimering	/se/BILAR/Upptack/Polestar-Engineered	*
/uk/order-online	/uk/Buy/Shop/Order-Online	*
/us/order-yours/orderpreview	/us/MaintenancePage	*
/de/original-ersatzteile	/de/Zubehoer-und-Services/Services/Serviceleistungen/Original-Ersatzteile	*
/se/originalservice	/se/agande/service-och-underhall/originalservice	*
/se/originalservice-classic	/se/AGA/Service/Service-och-Underhall/Originalservice-Classic	*
/us/osd	/us/buy/shopping-tools/overseas-delivery	*
/us/ourfuturethinking	/us/about/our-innovations/intellisafe/intellisafe-autopilot	*
/nl/overbanden	/nl/Service-en-Accessoires/Onderhoud-en-reparatie/Volvo-Banden	*
/us/owners	/us/own/owner-info/owners-manuals	*
/se/p1800	/se/edit/artikel/pelle-pettersson-p1800	*
/at/partner	/at/volvo-partner	*
/lu/peo	/lu/Acheter/Polestar-Engineered-Optimisation	*
/be/peo-fr	/fr-be/acheter/polestar-engineered-optimisation	*
/be/peo-nl	/nl-be/kopen/polestar-engineered-optimisation	*
/jp/pet	/jp/about/our-stories/volvo-pet	*
/jp/phevcp	/jp/cp/phevcp	*
/at/polestar	/at/service-und-zubehoer/mehr-entdecken/polestar-optimierung	*
/ch/polestar	/de-ch/Redirects/Polestar	*
/cz/polestar	/cz/sluzby/vyber-a-koupe/polestar-performance	*
/de/polestar	/de/beratung-und-kauf/unsere-leistungen/polestar-performance	*
/nl/polestar	/nl/Service-en-Accessoires/Accessoires/Accessoires/Polestar-Optimised	*
/se/polestar	/se/BILAR/Upptack/Polestar-Engineered	*
/uk/polestar	/uk/buy/sales/accessories/polestar	*
/se/polestar-optimering	/se/BILAR/Upptack/Polestar-Engineered	*
/nl/polestar-optimised	/nl/Service-en-Accessoires/Accessoires/Accessoires/Polestar-Optimised	*
/uk/polestaroptimisation	/uk/Buy/Finance-Sales/Accessories/Polestar/Optimised	*
/jp/popupstore	/jp/cp/pop-up-store2019	*
/sk/preco-volvo/inovacie/bezpecnost/intellisafe-standard	/sk/Preco-Volvo/Inovacie/Safety	*
/sk/preco-volvo/inovacie/bezpecnost/system-intellisafe-surround	/sk/Preco-Volvo/Inovacie/Safety	*
/sk/preco-volvo/inovacie/buducnost-jazdy/pohon	/sk/Preco-Volvo/Inovacie/Elektrifikacia	*
/sk/preco-volvo/inovacie/buducnost-jazdy/pohon/elektricke-vozidla	/sk/Preco-Volvo/Inovacie/Elektrifikacia/Cisto-elektricke	*
/sk/preco-volvo/inovacie/buducnost-jazdy/pohon/mild-hybridy	/sk/Preco-Volvo/Inovacie/Elektrifikacia/Mild-hybrid	*
/sk/preco-volvo/inovacie/buducnost-jazdy/pohon/plug-in-hybridy	/sk/Preco-Volvo/Inovacie/Elektrifikacia/Plug-in-hybrid	*
/sk/preco-volvo/inovacie/buducnost-jazdy/pohon/spalovacie-motory	/sk/Preco-Volvo/Inovacie/Elektrifikacia	*
/sk/preco-volvo/inovacie/safety/IntelliSafe-standard	/sk/preco-volvo/inovacie/safety	*
/sk/preco-volvo/inovacie/safety/System-IntelliSafe-surround	/sk/preco-volvo/inovacie/safety	*
/sk/preco-volvo/inovacie/safety/bezpecne-vozidla-pre-vsetkych	/sk/Preco-Volvo/Inovacie/Safety	*
/sk/preco-volvo/nas-pribeh/innovations	/sk/Preco-Volvo/Inovacie/Safety/Safety-heritage	*
/br/precofixo	/br/proprietario/servico-manutencao/plano-revisao	*
/uk/price	/uk/buy/research/brochure-pricelist	*
/ch/price-lists	/de-ch/beratung-und-kauf/zusatzinformationen/preislisten/price-lists	*
/ie/pricelists	/ie/Buy/Research/Pricelists	*
/uk/pricelists	/uk/buy/research/brochure-pricelist	*
/uk/pricepromise	/uk/own/maintenance/service-and-maintenance/volvo-service-promise	*
/uk/prices	/uk/buy/research/brochure-pricelist	*
/uk/pricing	/uk/buy/research/brochure-pricelist	*
/lu/primedefidelite	/lu/campagnes/prime-de-fidelite	*
/se/prislista	/se/bilar/prislista	*
/nl/privacy	/nl/footer/privacy	*
/uk/privacy	/uk/support/article	*
/us/privacy	/us/footer/privacy	*
/be/privacybeleid	/nl-be/footer/privacybeleid	*
/uk/privacypolicy	/uk/footer/privacy	*
/nl/privatelease	/nl/ontdek/producten/prive/volvo-private-lease	*
/se/privatleasing	/se/agande/agande/privatleasing	*
/cz/pro-uzivatele/udrzba/servis-a-oprava/volvo-personal-service	/cz/pro-uzivatele/udrzba/servis-a-oprava	*
/cz/pro-uzivatele/uzivejte-si/detske-sedacky	/cz/pro-uzivatele/prislusenstvi/detske-sedacky	*
/cz/pro-uzivatele/uzivejte-si/detske-sedacky/FAQ	/cz/pro-uzivatele/uzivejte-si/detske-sedacky	*
/cz/pro-uzivatele/uzivejte-si/detske-sedacky/confirm-order	/cz/pro-uzivatele/uzivejte-si/detske-sedacky	*
/cz/pro-uzivatele/uzivejte-si/detske-sedacky/fill-order-forms	/cz/pro-uzivatele/uzivejte-si/detske-sedacky	*
/cz/pro-uzivatele/uzivejte-si/detske-sedacky/order-yours	/cz/pro-uzivatele/uzivejte-si/detske-sedacky	*
/cz/pro-uzivatele/uzivejte-si/detske-sedacky/rada-detskych-sedacek	/cz/pro-uzivatele/prislusenstvi/detske-sedacky	*
/cz/pro-uzivatele/uzivejte-si/detske-sedacky/stvorene-pro-zivot	/cz/pro-uzivatele/prislusenstvi/detske-sedacky	*
/cz/pro-uzivatele/uzivejte-si/detske-sedacky/submit-order	/cz/pro-uzivatele/uzivejte-si/detske-sedacky	*
/de/probefahren	/de/probefahrt	*
/it-ch/prodotti-e-servizi/servizi/connected-car/volvo-on-call	/it-ch/perch%C3%A9-volvo/human-innovation/future-of-driving/connettivit%C3%A0/volvo-on-call	*
/uk/productflyers	/uk/leasing/product-flyers	*
/nl/proefrit	/nl/test-drive-booking  *
/de/professional-car-care	/de/Zubehoer-und-Services/Services/Serviceleistungen	*
/de/professionalcarcare	/de/Zubehoer-und-Services/Services/Serviceleistungen	*
/fr/professionnels/contactez-nous/demander-une-offre  /fr/l/contactez-nous/demander-une-offre  *
/fr/professionnels/contactez-nous/offres-du-moment  /fr/l/offres-professionnels  *
/fr/professionnels/contactez-nous/reserver-un-essai  /fr/l/contactez-nous/reserver-un-essai  *
/fr/professionnels/contactez-nous/volvo-car-entreprise  /fr/l/contactez-nous/volvo-car-entreprise  *
/fr/professionnels/servir-votre-business/gamme-business  /fr/l/servir-votre-business/gamme-business  *
/fr/professionnels/servir-votre-business/lld-location-longue-duree  /fr/l/servir-votre-business/lld  *
/fr/professionnels/servir-votre-business/performance-ecologique  /fr/l/servir-votre-business/performance-ecologique  *
/fr/professionnels/servir-votre-business/volvo-car-entreprise  /fr/l/servir-votre-business/volvo-car-entreprise  *
/fr/professionnels/volvo-car-entreprise/fiscalite	/fr/professionnels/servir-votre-business/performance-ecologique	*
/be/promotie-van-de-maand	/nl-be/naverkoop/accessoires/promotie-van-de-maand	*
/be/promotion-du-mois	/fr-be/apres-vente/accessoires/promotion-du-mois	*
/lu/promotion-du-mois	/lu/apres-vente/accessoires/action-saisonniere	*
/se/propartner	/se/om-volvo/volvo-cars-world/volvo-car-pro-partner	*
/br/proprietario/aproveite-o-seu-volvo	/br/conveniencia/aproveite-seu-volvo/vps	*
/br/proprietario/aproveite-o-seu-volvo/recall-information	/br/conveniencia/aproveite-seu-volvo/recalls	*
/br/proprietario/explorar/carros-blindados	/br/modelos-volvo/armoured	*
/br/proprietario/informacao-proprietario/volvo-on-call/volvo-on-call	/br/proprietario/informacao-proprietario/Volvo-On-Call	*
/br/proprietario/manutencao	/br/conveniencia/aproveite-seu-volvo/servico-reparos	*
/br/proprietario/servico-manutencao/plano-revisao/revisao-drive-e	/br/proprietario/servico-manutencao/plano-revisao	*
/br/proprietario	/br/conveniencia/aproveite-seu-volvo/vps	*
/at/prospekt	/at/beratung-und-kauf/mehr-erfahren/infomaterial	*
/be/proxicar	/fr-be/acheter/votre-nouvelle-volvo/distributeurs	*
/uk/range	/uk/Cars/Model-Lineup	*
/us/recall	/us/own/owner-info/recall-information	*
/uk/recalls	/uk/Own/Maintenance/Volvo-Warranty/Recalls	*
/ch/recharge	/de-ch/redirects/recharge	*
/de/recharge	/de/v/cars/recharge	*
/uk/recharge	/uk/cars/xc40-pure-electric	*
/intl/recharge-models	/intl/v/cars/recharge	*
/nl/recharged	/nl/v/cars/recharge  *
/se/recharged	/se/v/cars/recharge	*
/be/rechargereport	/nl-be/modellen/gamma/xc40-recharge/blog	*
/de/rechte	/de/Footer/Kontakt/Subject-Request/Subject-Request-Form	*
/de/redirect-page-taxi	/de/Beratung-und-Kauf/Ueberblick/Business/Einsatzfahrzeuge/Taxi	*
/au/redirecttest	/au/find-a-dealer	*
/us/register	/us/footer/register-your-volvo	*
/ch/reiseschutz	/de-ch/Redirects/Volvo-Assistance	*
/ch/rent	/de-ch/Redirects/Volvo-Car-Rent	*
/fr-be/repaynature	/fr-be/support/contact-us	*
/mu/request-a-quote	/mu/quote	*
/uk/retail	/uk/find-a-dealer	*
/it/retail   /it/concessionari       *
/se/retail  https://www.volvocarretail.se/  *
/ca/retailers	/en-ca/find-a-retailer	*
/uk/retailers	/uk/Find-A-Dealer	*
/de/robinson	/de/volvo/mehr-volvo/robinson	*
/be/roues-accessoires	/fr-be/accessoires/roues-et-jantes	*
/lu/roues-accessoires	/lu/accessoires/roues-et-jantes	*
/be/roues-accessoires-promotion	/fr-be/accessoires/roues-et-jantes	*
/lu/roues-accessoires-promotion	/lu/accessoires/roues-et-jantes	*
/be/roueshiver	/fr-be/accessoires/roues-et-jantes/roues-hiver-completes	*
/lu/roueshiver	/lu/apres-vente/entretien/entretien-et-reparation	*
/de/rueckruf	/de/Zubehoer-und-Services/Services/Volvo-Rueckruf	*
/us/runningclub	/us/shopping-tools/additional-choices/events/volvo-cars-running-club	*
/jp/s-promise	/jp/own/maintenance/maintenance/volvo-service-promise	*
/at/s60	/at/modelle/unsere-modelle/s60	*
/ca/s60	/en-ca/cars/new-models/s60	*
/ch/s60	/de-ch/Redirects/S60	*
/cz/s60	/cz/vozy/modely/volvo-s60	*
/de/s60	/de/modelle/neuwagen/s60	*
/fi/s60	/fi/mallisto/mallit/s60	*
/jp/s60	/jp/cars/new-models/s60	*
/lu/s60	/lu/modeles/gamme/s60	*
/lu/s60-classic	/lu/v/cars/s60-hybrid	*
/fi/s60-cross-country	/fi/mallisto/mallit/s60-cross-country	*
/uk/s60crosscontry	/uk/cars/new-models/s60/variants	*
/zh-cn/s60hub	/zh-cn/cars/new-models/s60	*
/us/s60lookbook	/us/cars/new-models/s60	*
/cz/s80	/cz/vozy/modely/volvo-s60	*
/de/s80	/de/modelle/neuwagen/s80	*
/fi/s80-classic	/fi/mallisto/mallit/s80-classic	*
/be/s80brochures	/be	*
/uk/s80pricelist	/uk/cars/new-models/s80/variants	*
/at/s90	/at/modelle/unsere-modelle/volvo-s90	*
/ch/s90	/de-ch/Redirects/S90	*
/de/s90	/de/v/cars/S90-hybrid	*
/lu/s90	/lu/modeles/gamme/s90	*
/no/s90	/no/cars/new-models/s90	*
/uk/s90	/uk/cars/new-models/s90	*
/se/s90insidan	/se/bilar/modeller/s90/insidan	*
/uk/s90news	/uk/cars/new-models/s90/keep-me-updated/personal	*
/uk/s90testdrive	/uk/cars/new-models/s90/test-drive	*
/de/safe-leasing	/de/stayhomestore/	*
/uk/safetyinspection	/uk/about/our-innovations/intellisafe	*
/uk/sailing	/uk/about/humanmade/partnerships/sailing	*
/se/salen	/se/om-volvo/aktuella-handelser/salen	*
/kr/sales/sales/find-a-dealer	/kr/buy/purchase/showroom	*
/au/sales	/au/buy/sales/offers/my17	*
/en-ca/sales-service/sales/european-delivery/pages	/en-ca/cars/european-delivery	*
/en-ca/sales-service/sales/pre-owned-inventory/pages	/en-ca/cars/certified-pre-owned	*
/en-ca/sales-service/sales/sensus-connected-touch/pages	/en-ca/about/our-innovations/sensus	*
/en-ca/sales-service/sales/sound-navigation/nav-system/pages	/en-ca/services/apps-and-services/sensus-connect	*
/en-ca/sales-service/sales/sound-navigation/pages	/en-ca/services/apps-and-services/sensus-connect	*
/en-ca/sales-service/sales/sound-navigation/sirius-satellite-radio/pages	/en-ca/services/apps-and-services/sensus-connect	*
/fr-ca/sales-service/sales/sensus-connected-touch/pages	/fr-ca/about/our-innovations/sensus	*
/fr-ca/sales-service/sales/sound-navigation/nav-system/pages	/fr-ca/services/apps-and-services/sensus-connect	*
/fr-ca/sales-service/sales/sound-navigation/pages	/fr-ca/services/apps-and-services/sensus-connect	*
/de/salesandservices/fleetsales	/de/beratung-und-kauf/ueberblick/geschaeftswagen	*
/fr-be/salesandservices/fleetsales	/fr-be/modeles/fleet	*
/lu/salesandservices/fleetsales	/lu/modeles/fleet	*
/nl-be/salesandservices/fleetsales	/nl-be/modellen/fleet	*
/no/salesandservices/fleetsales	/no/cars/fleet-sales	*
/se/salesandservices/Dack/FalgGenerator	/se/aga/service/service-och-underhall/dack	*
/us/salesandservices/overseasdelivery/AddedIncentives	/us/own/maintenance	*
/br/salesandservices	/br/conveniencia/idealize-seu-volvo/servicos-financeiros	*
/nl-be/salon/model	/nl-be/modellen	*
/nl-be/salon	/nl-be/modellen	*
/uk/satnavmapupdate	/uk/own/enjoy/navigation-maps	*
/de/schwedenfinanzierung	/de/beratung-und-kauf/ueberblick/gebrauchtwagen/schwedenfinanzierung	*
/de/schwedenflotte	/de/beratung-und-kauf/ueberblick/mietwagen/schwedenflotte-sylt	*
/de/schwedenkasko	/de/Beratung-und-Kauf/Unsere-Leistungen/schwedenversicherung/Schwedenkasko	*
/de/schwedenleasing	/de/Beratung-und-Kauf/Unsere-Leistungen/Financial-Services/Leasingprodukte/Schwedenleasing	*
/de/schwedenversicherung	/de/Beratung-und-Kauf/Unsere-Leistungen/schwedenversicherung	*
/it-ch/scopri-volvo/forward-thinking	/it-ch/scopri-volvo	*
/it-ch/scopri-volvo/nyc-sleep	/it-ch/scopri-volvo	*
/se/se/kop/utforska/laddhybrider	/se/OM-VOLVO/Innovation/Elektrifiering/Laddhybrider	*
/be/seizoensactie/Volvowheelsapp	/nl-be/accessoires/redirect/volvowheelsapp	*
/be/seizoensactie/zomerwielen	/nl-be/accessoires/seizoensactie	*
/be/seizoensactie	/nl-be/accessoires/seizoensactie	*
/be/seizoenscheck	/nl-be/naverkoop/uw-volvo/onderhoud-en-reparatie/seizoenscheck	*
/de/select  /de/l/beratung-und-kauf/gebrauchtwagen  *
/at/selekt	/at/beratung-und-kauf/angebote/gebrauchtwagen	*
/ch/selekt	/de-ch/Redirects/selekt	*
/cz/selekt	/cz/vozy/skladove-a-ojete/volvo-selekt	*
/de/selekt	/de/Beratung-und-Kauf/Ueberblick/Gebrauchtwagen	*
/lu/selekt	/lu/volvo-selekt	*
/nl/selekt	/de/l/beratung-und-kauf/gebrauchtwagen  *
/no/selekt	/no/cars/volvo-selekt	*
/be/selekt-week	/nl-be/volvo-selekt/volvo-selekt-week	*
/intl/selfie-for-safety	/intl/why-volvo/human-innovation/future-of-driving/safety/cars-safe-for-all/selfie-for-safety/	*
/lu/semaine-selekt	/lu/volvo-selekt/semaine-volvo-selekt	*
/se/senasteomv60cc	/se/bilar/modeller/v60/utrustningsnivaer/cross-country/#senasteOmV60	*
/de/sensus	/de/Volvo/Innovationen/Konnektivitaet/Sensus	*
/lu/sensus	/lu/pourquoi-volvo/innovation-humaine/avenir-de-la-conduite/connectivite/sensus-navigation	*
/be/sensus-fr	/fr-be/pourquoi-volvo/innovation-humaine/avenir-de-la-conduite/connectivite/sensus-navigation	*
/be/sensus-nl	/nl-be/waarom-volvo/innovaties/future-of-driving/connectiviteit/sensus-navigatie	*
/us/sensusconnect	/us/own/owner-info/sensus-connect	*
/au/serv	/au/own/maintenance/service-and-repair	*
/il/service/service-and-maintenance/dealers	/il/find-a-dealer	*
/il/service/service-and-maintenance/service-dealers	/il/find-a-dealer	*
/it/service/accessori-e-offerte/accessori  /it/l/service/accessori-e-offerte/accessori/  *
/it/service/accessori-e-offerte/accessori/child-seats	/it/service/accessori-e-offerte/accessori/seggiolini-per-bambini	*
/it/service/accessori-e-offerte/promozione-accessori-inverno	/it/service/accessori-e-offerte/accessori	*
/it/service/accessori-e-offerte/promozione-accessori-inverno/s60-s60cc-v60-v60cc	/it/service/accessori-e-offerte/accessori	*
/it/service/accessori-e-offerte/promozione-accessori-inverno/s90-v90-v90cc-xc60-xc90	/it/service/accessori-e-offerte/accessori	*
/it/service/accessori-e-offerte/promozione-accessori-inverno/v40-v40cc	/it/service/accessori-e-offerte/accessori	*
/it/service/accessori-e-offerte/promozione-accessori-inverno/v50-v70-xc70	/it/service/accessori-e-offerte/accessori	*
/it/service/accessori-e-offerte/promozione-accessori-inverno/xc60-classic	/it/service/accessori-e-offerte/accessori	*
/it/service/esplora/configurazione-infotainment  /it/l/service/configurazione-infotainment  *
/it/service/manutenzione-e-offerte/accessori	/it/service/esplora/accessori	*
/it/service/manutenzione-e-offerte/black-friday-volvo	/it/service/manutenzione-e-offerte/accessori	*
/it/service/servizi-per-il-cliente/calcola-prezzo-tagliando	/it/service/servizi-per-il-cliente/service-by-volvo/calcola-prezzo-tagliando	*
/it/service/servizi-per-il-cliente/volvo-personal-service	/it/service/servizi-per-il-cliente/service-by-volvo/volvo-personal-service	*
/nl/service/in-de-spotlight/wielen/winterwielen	/nl/Service-en-Accessoires/Onderhoud-en-reparatie/Volvo-Banden/Winterwielen	*
/nl/service/onderhoud-en-reparatie/onderhoud	/nl/Service-en-Accessoires/Onderhoud-en-reparatie/Service-by-Volvo	*
/nl/service/onderhoud-en-reparatie/onderhoud/afspraak-maken	/nl/Service-en-Accessoires/Onderhoud-en-reparatie/Service-by-Volvo/Afspraak-maken	*
/nl/service/onderhoud-en-reparatie/onderhoud/apk	/nl/Service-en-Accessoires/Onderhoud-en-reparatie/Service-by-Volvo/APK	*
/nl/service/onderhoud-en-reparatie/onderhoud/assistance	/nl/Service-en-Accessoires/Onderhoud-en-reparatie/Service-by-Volvo/Assistance	*
/nl/service/onderhoud-en-reparatie/onderhoud/assistance/declaraties	/nl/Service-en-Accessoires/Onderhoud-en-reparatie/Service-by-Volvo/Assistance/Declaraties	*
/nl/service/onderhoud-en-reparatie/onderhoud/service-price-indicator	/nl/Service-en-Accessoires/Onderhoud-en-reparatie/Service-by-Volvo/Onderhoudsprijzen	*
/nl/service/onderhoud-en-reparatie/service-by-volvo	/nl/Service-en-Accessoires/Onderhoud-en-reparatie/Service-by-Volvo	*
/nl/service/onderhoud-en-reparatie/service-by-volvo/afspraak-maken	/nl/Service-en-Accessoires/Onderhoud-en-reparatie/Service-by-Volvo/Afspraak-maken	*
/nl/service/onderhoud-en-reparatie/service-by-volvo/apk	/nl/Service-en-Accessoires/Onderhoud-en-reparatie/Service-by-Volvo/APK	*
/nl/service/onderhoud-en-reparatie/service-by-volvo/onderhoudsprijzen	/nl/Service-en-Accessoires/Onderhoud-en-reparatie/Service-by-Volvo/Onderhoudsprijzen	*
/nl/service/uw-volvo	/nl/Service-en-Accessoires/Onderhoud-en-reparatie/Service-by-Volvo	*
/nl/service/uw-volvo/accessoires	/nl/Service-en-Accessoires/Accessoires/Accessoires	*
/nl/service/uw-volvo/accessoires/polestar-optimised	/nl/Service-en-Accessoires/Accessoires/Accessoires/Polestar-Optimised	*
/nl/service/uw-volvo/accessoires/polestar-tuning	/nl/service/in-de-spotlight/optimised	*
/nl/service/uw-volvo/accessoires/wielensets	/nl/Service-en-Accessoires/Onderhoud-en-reparatie/Volvo-Banden	*
/de/service	/de/Zubehoer-und-Services/Services/Serviceleistungen	*
/lu/service	/lu/apres-vente/votre-volvo/entretien-et-reparation	*
/nl/service	/nl/service/onderhoud-en-reparatie/onderhoud	*
/se/service	/se/volvohandlare	*
/uk/service	/uk/own/maintenance/service-and-maintenance/volvo-service-promise	*
/se/sidfot/Sekretesspolicy  /<market>/v/legal/sekretesspolicy  *
/se/sidfot/cookies  /<market>/v/legal/cookies  *
/se/sidfot/gdpr-privacy  /<market>/v/legal/gdpr-privacy  *
/se/sidfot/hantering-av-personuppgifter     /se/support/article/9bd9e960fe38bc1cc0a801517a4552fb    *
/se/sidfot/hantering-av-personuppgifter/subject-rights-request-form    /<market>/subject-rights-request-form  *
/se/sidfot/nyhetsbrev/  /se/l/nyhetsbrev/  *
/se/sidfot/sociala-medier  /<market>/v/legal/sociala-medier  *
/se/sidfot/test-fbi/familjebilar  /se/l/familjebil/  *
/se/sidfot/test-fbi/gamla-sidor/byta-vindruta  /se/l/vindruta/  *
/se/sidfot/test-fbi/privatleasing-priser  /se/l/privatleasing/  *
/se/sidfot/villkor  /<market>/v/legal/villkor  *
/nl/support	/nl/support/topics  *
/nl/terugroepactie	/nl  *
/nl/zomer	/nl/l/zomer  *
ns nop
/ro/Test%20Drive    /ro/Forms/tdr   *
/ch/XC40Recharge    /de-ch/redirects/xc40recharge   *
/nl/c40  /nl/v/cars/c40-electric  *
/nl/service-en-accessoires/accessoires/aanbiedingen	/nl/l/aanschaf-en-lease/accessoires-aanbiedingen/  *
/nl/service-en-accessoires/accessoires/accessoires	/nl/l/aanschaf-en-lease/accessoires  *
/nl/service-en-accessoires/accessoires/accessoires/accessoires-modellen/accessoires-s60	/nl/l/aanschaf-en-lease/accessoires  *
/nl/service-en-accessoires/accessoires/accessoires/accessoires-modellen/accessoires-s90	/nl/l/aanschaf-en-lease/accessoires  *
/nl/service-en-accessoires/accessoires/accessoires/accessoires-modellen/accessoires-v60	/nl/l/aanschaf-en-lease/accessoires  *
/nl/service-en-accessoires/accessoires/accessoires/accessoires-modellen/accessoires-v90	/nl/l/aanschaf-en-lease/accessoires  *
/nl/service-en-accessoires/accessoires/accessoires/accessoires-modellen/accessoires-xc40	/nl/l/aanschaf-en-lease/accessoires  *
/nl/service-en-accessoires/accessoires/accessoires/accessoires-modellen/accessoires-xc60	/nl/l/aanschaf-en-lease/accessoires  *
/nl/service-en-accessoires/accessoires/accessoires/accessoires-modellen/accessoires-xc90	/nl/l/aanschaf-en-lease/accessoires  *
/nl/service-en-accessoires/accessoires/accessoires/kinderzitjes	/nl  *
/nl/service-en-accessoires/accessoires/accessoires/kinderzitjes/configurator	/nl  *
/nl/service-en-accessoires/accessoires/accessoires/kinderzitjes/getest-op-het-leven  /nl  *
/nl/service-en-accessoires/navigatie-update	/nl/support/downloads/maps	*
/nl/service-en-accessoires/onderhoud-en-reparatie/schadeherstel	 /nl/l/mijn-volvo/service-en-onderhoud/  *
/nl/service-en-accessoires/onderhoud-en-reparatie/service-by-volvo/afspraak-maken	/nl/l/mijn-volvo/service-en-onderhoud/  *
/nl/service-en-accessoires/onderhoud-en-reparatie/service-by-volvo/apk	/nl/l/mijn-volvo/apk/  *
/nl/service-en-accessoires/onderhoud-en-reparatie/service-by-volvo/assistance  /nl/l/mijn-volvo/assistance/  *
/nl/service-en-accessoires/onderhoud-en-reparatie/service-by-volvo/assistance/declaraties	https://volvocarstools.nl/app/declarations/  *
/nl/service-en-accessoires/onderhoud-en-reparatie/service-by-volvo/onderhoudsprijzen	http://serviceprice-nl.marketsupport.net/  *
/nl/service-en-accessoires/onderhoud-en-reparatie/service-by-volvo/onderhoudsprijzen/model	http://serviceprice-nl.marketsupport.net/  *
/nl/service-en-accessoires/onderhoud-en-reparatie/service-by-volvo/onderhoudsprijzen/prijs-en-maak-een-afspraak	/nl/l/mijn-volvo/service-en-onderhoud/  *
/nl/service-en-accessoires/onderhoud-en-reparatie/service-by-volvo/onderhoudsprijzen/service-price-indicator	http://serviceprice-nl.marketsupport.net/  *
/nl/service-en-accessoires/onderhoud-en-reparatie/service-by-volvo/onderhoudsprijzen/verdelers	/nl/dealers/autodealers  *
/nl/service-en-accessoires/onderhoud-en-reparatie/volvo-banden	/nl/l/aanschaf-en-lease/volvo-banden/  *
/nl/service-en-accessoires/onderhoud-en-reparatie/volvo-banden/winterwielen	/nl/l/aanschaf-en-lease/winterwielen/  *
/nl/service-en-accessoires/uw-volvo/terugroepactie	/nl  *
/be/service-fr	/fr-be/apres-vente/votre-volvo/entretien-et-reparation	*
/be/service-nl	/nl-be/naverkoop/uw-volvo/onderhoud-en-reparatie	*
/at/service-und-zubehoer/ihr-volvo/zubehoer	/at/zubehoer-und-service/zubehoer/zubehoer	*
/at/service-und-zubehoer/mehr-entdecken/freie-werkstaetten	/at/Zubehoer-und-Service/Dokumente-und-Hilfe/Freie-Werkstaetten	*
/at/service-und-zubehoer/mehr-entdecken/polestar-optimierung	/at/Beratung-und-Kauf/Kauf/Polestar-Optimierung	*
/at/service-und-zubehoer/mehr-entdecken/volvo-rettungsleitfaeden	/at/Zubehoer-und-Service/Dokumente-und-Hilfe/Volvo-Rettungsleitfaeden	*
/at/service-und-zubehoer/unser-service/professional-car-care	/at/Zubehoer-und-Service/Service/Professional-Car-Care	*
/at/service-und-zubehoer/unser-service/service-und-garantie	/at/Zubehoer-und-Service/Service/Service-und-Garantie	*
/at/service-und-zubehoer/unser-service/service-und-garantie/volvo-service-und-garantiepakete/Service%20Garantiepakete	/at/Zubehoer-und-Service/Service/Service-und-Garantie/Volvo-Service-und-Garantiepakete/Service-Garantiepakete	*
/at/service-und-zubehoer/unser-service/service-und-garantie/volvo-service-und-garantiepakete/service-garantiepakete-fuer-jung-und-gebrauchtwagen	/at/Zubehoer-und-Service/Service/Service-und-Garantie/Volvo-Service-und-Garantiepakete/Service-Garantiepakete-fuer-Jung-und-Gebrauchtwagen	*
/at/service-und-zubehoer/unser-service/serviceleistungen	/at/Zubehoer-und-Service/Service/Serviceleistungen	*
/at/service-und-zubehoer/unser-service/serviceleistungen/altfahrzeugverwertung	/at/Zubehoer-und-Service/Dokumente-und-Hilfe/Altfahrzeugverwertung	*
/at/service-und-zubehoer/unser-service/volvo-rueckruf-information	/Ueber-Volvo/Unsere-Innovationen/Zukunft-des-Fahrens/Sicherheit/Volvo-Rueckruf-Information	*
/ch/service2	/de-ch/Redirects/Volvo-Service-20	*
/ch/service2.0	/de-ch/Redirects/Volvo-Service-20	*
/nl/service2.0	/nl/service/onderhoud-en-reparatie/onderhoud	*
/be/service20	/be	*
/lu/service20	/lu/apres-vente/entretien/entretien-et-reparation	*
/be/service20-fr	/fr-be/apres-vente/entretien/entretien-et-reparation	*
/be/service20-nl	/nl-be/naverkoop/onderhoud/onderhoud-en-reparatie	*
/de/serviceaktion	/de/Zubehoer-und-Services/Services/Serviceleistungen	*
/uk/servicebooking	/uk/Own/Maintenance/Service-and-Maintenance	*
/de/servicebyvolvo	/de/Zubehoer-und-Services/Services/Serviceleistungen	*
/us/servicebyvolvo	/us/own/service-by-volvo	*
/de/servicecheck	/de/zubehoer-und-services/zubehoer-und-services/servicecheck	*
/uk/serviceplan	/uk/Own/Maintenance/Service-and-Maintenance	*
/uk/serviceplans	/uk/own/maintenance/service-and-maintenance/volvo-service-plans	*
/ie/servicepromise	/ie/own/maintenance/service-promise	*
/uk/servicepromise	/uk/own/maintenance/service-and-maintenance/volvo-service-promise	*
/ro-md/servicii/own_and_enjoy/offers/xc90_offers	/ro-md/cars/gama-de-modele/xc90	*
/ro-md/servicii/posesie-si-bucurie/offers/xc60-winter-edition	/ro/cars/new-models/xc60	*
/is/servises/design%20and%20buy/dlbi%20kmu	/is/Forms/kmu	*
/fr-ca/shoppingtools/purchase/request-a-quote	/fr-ca/quote	*
/se/showroom	/se/om-volvo/foretaget/upplev-volvo-cars	*
/de/sicherheit	/de/Volvo/Innovationen/Sicherheit	*
/be/siegesenfant	/fr-be/accessoires/securite-et-fabilite/sieges-enfants	*
/lu/siegesenfant	/fr-be/accessoires/securite-et-fiabilite/sieges-enfant-et-accessoires	*
/es/sitecore/content/international/discover-volvo	/es/discover-volvo	*
/es/sitecore/content/international/discover-volvo/stories-by-topic	/es/discover-volvo	*
/cz/sluzby/vyber-a-koupe/testovaci-jizda	/cz/test-drive-booking	*
/cz/sluzby/vyber-a-koupe/testovaci-jizda-hybrid	/cz/test-drive-booking	*
/cz/sluzby/vyber-a-koupe/wfsc-b2c-testdrive-request	/cz/test-drive-booking	*
/au/smartcare	/au/own/maintenance/smartcare	*
/se/smaskador	/se/aga/service/service-och-underhall/smaskador	*
/jp/smawari50	/jp/buy/sales/finance/smawari50	*
/uk/smrdata	/uk/leasing/smr-data	*
/de/so-schoen-kann-sicher-sein	/de/Modelle	*
/br/sobre/inovacao-que-esta-no-dna/drive-e	/br/sobre/nossas-inovacoes/drive-e	*
/br/sobre/inovacao-que-esta-no-dna/intellisafe	/br/sobre/nossas-inovacoes/intellisafe-carros-seguros	*
/br/sobre/inovacao-que-esta-no-dna/intellisafe/autopilot	/br/sobre/nossas-inovacoes/intellisafe-carros-seguros/autopilot	*
/br/sobre/nossa-empresa/heran%C3%A7a/inova%C3%A7%C3%B5es	/br/sobre/nossa-empresa/heranca-volvo/inovacoes	*
/br/sobre/nossa-empresa/somos-a-volvo/vis%C3%A3o-2020	/br/sobre/nossas-historias/visao-2020	*
/br/sobre/nossa-empresa/visao-2020	/br/porque-volvo/inovacao-humana/futuro-da-conducao	*
/br/sobre/nossa-empresa/volvo-cars-experience/visite-a-volvo-cars	/br/sobre/nossa-empresa/volvo-cars-experience	*
/br/sobre/nossas-historias/inova%C3%A7%C3%B5es/nossa-visao-do-futuro	/br/sobre/nossa-empresa/heranca-volvo/inovacoes	*
/br/sobre/nossas-historias/inovacoes/projetos-pilotos/hololens	/br/sobre/nossa-empresa/heranca-volvo/inovacoes	*
/br/sobre/nossas-historias/nossa-vers%C3%A3o-de-luxo	/br/modelos-volvo/carros-conceito	*
/br/sobre/nossas-historias/nossa-versao-de-luxo	/br/sobre/nossas-historias/nossa-versao-luxo	*
/br/sobre/nossas-historias/vis%C3%A3o-2020	/br/sobre/nossas-historias/visao-2020	*
/br/sobre/nossas-historias/visao-2020	/br/sobre/nossa-empresa/visao-2020	*
/br/sobre/nossas-inova%C3%A7%C3%B5es/intellisafe/autopilot	/br/sobre/nossas-inovacoes/intellisafe-carros-seguros/autopilot	*
/pt/sobre-a-volvo/as-nossas-estorias/discover-volvo-/Forward-Thinking	/pt/sobre-a-volvo/as-nossas-estorias/discover-volvo-	*
/pt/sobre-a-volvo/as-nossas-estorias/discover-volvo-/nyc-sleep	/pt/sobre-a-volvo/as-nossas-estorias/discover-volvo-	*
/uk/social	/uk/about/humanmade/news	*
/de/soschoenkannsichersein	/de/Modelle	*
/za/south-africa/find-a-dealer	/za/buy/research/find-a-dealer	*
/de/spezialfahrzeuge	/de/Beratung-und-Kauf/Ueberblick/Business/Einsatzfahrzeuge	*
/be/spi	/be	*
/de/spielstrasse	/de/volvo/mehr-volvo/ein-herz-fuer-kinder/spielstrasse	*
/be/sponsoring	/be	*
/uk/stayintouch	/uk/About/Our-Company/This-is-Volvo-Cars/Sustainability/StayInTouch	*
/de/stopp	/de/Deutschland	*
/it/studiomilano	/it/mondo-volvo/iniziative/studio-milano	*
/ch/style	/de-ch/Redirects/style	*
/us/summer-sales-event	/us/shopping-tools/additional-choices/events/summer-sales-event	*
/us/summersalesevent	/us/shopping-tools/additional-choices/events/summer-sales-event	*
/uk/sustainability	/uk/about/our-company/sustainability	*
/us/suvs	/us/cars/new-models/suv	*
/uk/svnews	/uk/buy/sales/specialist-sales/emergency-services	*
/jp/swedish	/jp/cp/swedish2019	*
/de/swedish-pages/connected-car	/de/volvo/innovationen/sensus	*
/de/swedish-pages/mehr-erleben/book-a-test-drive	/de/modelle	*
/de/sylt	/de/beratung-und-kauf/ueberblick/mietwagen/schwedenflotte	*
/ch/tack	/de-ch/redirects/tack	*
/de/taxi	/de/Beratung-und-Kauf/Ueberblick/Business/Einsatzfahrzeuge/Taxi	*
/uk/technologies	/uk/about/our-innovations/drive-e	*
/et-ee/teenused/proovi-ja-osta/request-a-quote	/et-ee/Forms/or	*
/et-ee/teenused/proovi-ja-osta/testdrive	/et-ee/Forms/tdr	*
/se/teknikerjobb	/se/OM-VOLVO/Foretaget/Karriar/Teknikerjobb	*
/uk/tempwheelkit	/uk/own/maintenance/volvo-assistance/temp-mobility-kit	*
/kr/test/test	/kr/The-Volvo-XC60-old	*
/nl/test	/nl/service/uw-volvo/accessoires#webshop	*
/ro-MD/test%20drive	/ro-MD/Forms/tdr-ro	*
/au/test-drive/new-landing-page	/au/buy/research/book-a-test-drive	*
/gr/test-drive	/gr/Services/Design-and-Buy/Book-a-test-drive	*
/ru-md/test-drive	/ru-md/Forms/tdr-ru	*
/bg/testdrive	/bg/Forms/tdr	*
/ch/testdrive	/de-ch/redirects/testdrive	*
/cz/testdrive	/cz/sluzby/vyber-a-koupe/testovaci-jizda	*
/et-ee/testdrive	/et-ee/Forms/tdr	*
/mu/testdrive	/mu/test-drive-booking	*
/uk/testdrive	/uk/buy/design-and-buy/book-a-test-drive	*
/uk/testdriveplus/terms	/uk/Buy/Research/Test-Drive/Plus/Terms	*
/uk/testdriveplus	/uk/Buy/Research/Test-Drive/Plus	*
/be/testrit	/nl-be/verkoop/configureer-en-koop/boek-een-testrit	*
/be/testvaa	/be	*
/uk/thehunt	/uk/about/humanmade/discover-volvo	*
/uk/these-woods	/uk/about/humanmade/discover-Volvo/these-woods	*
/uk/thesewoods	/uk/about/humanmade/discover-Volvo/these-woods	*
/uk/theunseenocean	/uk/about/humanmade/discover-volvo/unseen-ocean	*
/no/tilbehor	/no/cars/options/accessories	*
/se/tillbehor	/se/AGA/Tillbehor/Tillbehor	*
/se/tjejvasan	/se/OM-VOLVO/Foretaget/Partnerskap/Tjejvasan	*
/uk/tools/leasinglogin/	/uk/leasing	*
/by/topmunity/heritage/pages	/by/about/our-company/heritage	*
/cz/topmunity/events/pages	/cz/o-nas/o-spolecnosti/novinky-a-udalosti	*
/cz/topmunity/followus/pages	/cz/paticka/kontakt	*
/de-CH/topmunity/ambassadors/pages	/de-CH/ueber-volvo/ueber-uns/ambassadoren	*
/es/topmunity/heritage	/es/acerca-de-volvopania/origen-volvo	*
/es/topmunity/heritage/pages	/es/acerca-de-volvopania/origen-volvo	*
/fi/topmunity/heritage	/fi/tietoa-volvosta/yrityksemme/historia	*
/fi/topmunity/heritage/pages	/fi/tietoa-volvosta/yrityksemme/historia	*
/fr-be/topmunity/heritage/pages	/fr-be/a-propos-de-volvo/notre-organisation/heritage	*
/fr/topmunity/clubs/pages	/fr/univers-volvo/notre-entreprise/heritage	*
/fr/topmunity/heritage	/fr/univers-volvo/notre-entreprise/heritage	*
/fr/topmunity/heritage/pages	/fr/univers-volvo/notre-entreprise/heritage	*
/hr/topmunity/heritage	/hr/o-volvu/nasa-tvrtka/nasljedje	*
/hr/topmunity/s60-blind-preview/pages	/hr/vozila/novi-modeli/s60	*
/nl-be/topmunity/heritage/pages	/nl-be/over-volvo/onze-organisatie/heritage	*
/no/topmunity/heritage/pages	/no/about/our-company/heritage	*
/ru/topmunity/heritage	/ru/about/our-company/heritage	*
/ru/topmunity/heritage/pages	/ru/about/our-company/heritage	*
/si/topmunity/heritage	/si/o-volvu/nase-podjetje/dediscina	*
/si/topmunity/heritage/pages	/si/o-volvu/nase-podjetje/dediscina	*
/si/topmunity/s60-blind-preview/pages	/si/vozila/novi-modeli/s60	*
/th/topmunity/clubs/pages	/th/	*
/th/topmunity/heritage	/th/	*
/th/topmunity/heritage/pages	/th/	*
/th/topmunity/s60-blind-preview/pages	/th/	*
/th/topmunity/videos/pages	/th/	*
/uk/topmunity/heritage	/uk/about/our-company/heritage	*
/uk/topmunity/heritage/pages	/uk/about/our-company/heritage	*
/th/topmunity	/th/	*
/uk/topmunity	/uk/about/our-company/this-is-volvo-cars	*
/lu/totalserviceplan	/lu/acheter/services-volvo/extended-services/volvo-total-service-plan	*
/be/totalserviceplan-fr	/fr-be/acheter/services-volvo/extended-services/total-service-plan	*
/be/totalserviceplan-nl	/nl-be/kopen/volvo-diensten/extended-services/total-service-plan	*
/lu/trouvez-un-concessionnaire	/lu/acheter/votre-nouvelle-volvo/trouvez-votre-concessionnaire	*
/nl/tuning	/nl/service/uw-volvo/accessoires#tuning	*
/nl-be/tweedehands	/nl-be/volvo-selekt	*
/ch/twin-engine	/de-ch/Redirects/Twin-Engine	*
/uk/tyres	/uk/own/maintenance/service-and-maintenance/tyres	*
/de/ueber/our-innovations/sicherheit	/de/Volvo/Innovationen/Sicherheit	*
/uk/uk/find-a-dealer	/uk/find-a-dealer	*
/is/um-volvo/bilaframleidandinn-volvo/arfleifd/nyskopun	/is/Why-Volvo/Human-Innovation/Safety/Safety-heritage	*
/de/umweltpraemie	/de/Volvo/Innovationen/Motorentechnik	*
/uk/unseenocean	/uk/about/humanmade/discover-volvo/unseen-ocean	*
/jp/upgrade	/jp/buy/sales/accessories/intellisafe-software-upgrade	*
/uk/used	/uk/cars/used-cars	*
/cz/v40	/cz/vozy/modely/volvo-v40	*
/de/v40	/de/modelle/neuwagen/v40	*
/fi/v40	/fi/mallisto/mallit/v40	*
/jp/v40	/jp/cars/new-models/v40	*
/se/v40	/se/bilar/modeller/v40	*
/fi/v40-cross-country	/fi/mallisto/mallit/v40-cross-country	*
/be/v40brochures	/be	*
/se/v40cbv	/se/care-by-volvo	*
/jp/v40cc	/jp/cars/new-models/v40-cross-country	*
/be/v40ccbrochures	/be	*
/ch/v40crosscountry	/de-ch/Redirects/v40cc	*
/de/v50	/de/Deutschland	*
/se/v50	/se/bilar/modeller/v40	*
/at/v60	/at/modelle/unsere-modelle/volvo-v60	*
/ca/v60	/en-ca/cars/new-models/v60	*
/ch/v60	/de-ch/Redirects/V60	*
/cz/v60	/cz/vozy/modely/volvo-v60	*
/de/v60	/de/v/cars/v60-hybrid	*
/fi/v60	/fi/mallisto/mallit/v60	*
/jp/v60	/jp/cars/new-models/v60	*
/se/v60	/se/bilar/modeller/v60	*
/fi/v60-cross-country	/fi/mallisto/mallit/v60-cross-country	*
/ch/v60-for-business	/de-ch/redirects/v60-for-business	*
/ch/v60-recharge-for-business	/de-ch/redirects/v60-recharge-for-business	*
/be/v60brochures	/be	*
/jp/v60cc	/jp/cars/new-models/v60-cross-country	*
/se/v60cc	/se/bilar/modeller/v60-cross-country	*
/ca/v60crosscountry	/en-ca/cars/new-models/v60-cross-country	*
/ch/v60crosscountry	/de-ch/Redirects/v60cc	*
/uk/v60fleet	/uk/Cars/Business-Sales/New-V60	*
/uk/v60loyalty	/uk/Cars/New-Models/V60/V60-Loyalty-Offer	*
/uk/v60phev	/uk/cars/new-models/v60/variants	*
/be/v60phevbrochures	/be	*
/be/v60pluginhybrid	/be	*
/ie/v60pluginhybrid	/ie/cars/new-models/v60	*
/uk/v60polestar	/uk/cars/new-models/v60/variants	*
/de/v70	/de/modelle/neuwagen/v70	*
/nl/v70	/nl/Modellen/Model/V60	*
/uk/v70	/uk/cars/new-models/v70	*
/fi/v70-classic	/fi/mallisto/mallit/v70-classic	*
/be/v70brochures	/be	*
/at/v90	/at/modelle/unsere-modelle/volvo-v90	*
/ch/v90	/de-ch/Redirects/V90	*
/cz/v90	/cz/vozy/modely/volvo-v90	*
/de/v90	/de/v/cars/V90-hybrid	*
/jp/v90	/jp/cars/new-models/v90	*
/no/v90	/no/cars/new-models/v90	*
/se/v90	/se/bilar/modeller/v90	*
/uk/v90	/uk/cars/new-models/v90	*
/de/v90cc	/de/modelle/neuwagen/der-neue-volvo-v90/ausstattungslinien/der-neue-volvo-v90-cross-country	*
/jp/v90cc	/jp/cars/new-models/v90-cross-country	*
/ch/v90crosscountry	/de-ch/Redirects/V90cc	*
/de/v90crosscountry	/de/modelle/neuwagen/der-neue-volvo-v90/ausstattungslinien/der-neue-volvo-v90-cross-country	*
/nl/v90crosscountry	/nl/modellen/model/v90-cross-country	*
/jp/valentine	/jp/cp/valentine2020	*
/be/vanisacker	/nl-be/kopen/uw-nieuwe-volvo/volvo-verdelers	*
/ro/vanzari/servicii/accident-si-reparatii	/ro/Service/Informatii/Suport	*
/ro/vanzari/servicii/mentenanta	/ro/Service/Servicii/Mentenanta	*
/ro/vanzari/servicii/support	/ro/Service/Informatii/Suport	*
/se/vasaloppet	/se/OM-VOLVO/Foretaget/Partnerskap/Vasaloppet	*
/de/vbf2019	/de/Beratung-und-Kauf/Ueberblick/Business	*
/nl/vcfs	/nl/ontdek/producten/vcfs	*
/br/vendas-especiais/pcd/volvo-for-all	/br/comprar/compre-seu-volvo/vendas-especiais/pcd/volvo-for-all	*
/fr-be/vente/configurez-et-achetez/DLBi-MV-Password-recovery	/fr-be/acheter/votre-nouvelle-volvo/DLBi-MV-Password-recovery	*
/fr-be/vente/configurez-et-achetez/DLBi-MV-Password-recovery-with-Powersearch-TEST	/fr-be/acheter/votre-nouvelle-volvo/DLBi-MV-Password-recovery-with-Powersearch-TEST	*
/fr-be/vente/configurez-et-achetez/Newsletter	/fr-be/acheter/votre-nouvelle-volvo/Newsletter	*
/fr-be/vente/configurez-et-achetez/brochures-et-listes-de-prix	/fr-be/acheter/votre-nouvelle-volvo/brochures-et-listes-de-prix	*
/fr-be/vente/configurez-et-achetez/comparateur-volvo	/fr-be/acheter/votre-nouvelle-volvo/comparateur-de-modeles-volvo	*
/fr-be/vente/configurez-et-achetez/demandez-une-offre	/fr-be/acheter/votre-nouvelle-volvo/demandez-une-offre	*
/fr-be/vente/configurez-et-achetez/ebrochure-thank-you	/fr-be/acheter/votre-nouvelle-volvo/ebrochure-thank-you	*
/fr-be/vente/configurez-et-achetez/offres	/fr-be/acheter/votre-nouvelle-volvo/offres	*
/fr-be/vente/configurez-et-achetez/reservez-un-essai	/fr-be/acheter/votre-nouvelle-volvo/reservez-un-essai	*
/fr-be/vente/configurez-et-achetez/trouvez-votre-concessionnaire	/fr-be/acheter/votre-nouvelle-volvo/trouvez-votre-concessionnaire	*
/fr-be/vente/selection/private-lease	/fr-be/acheter/services-volvo/financement-et-leasing/private-use/private-lease	*
/fr-be/vente/services-supplementaires/diplomat-military-expat	/fr-be/acheter/services-volvo/diplomat-military-expat	*
/fr-be/vente/services-supplementaires/volvo-car-insurance	/fr-be/acheter/services-volvo/assurance-omnium	*
/fr-be/vente/services-supplementaires/volvo-financial-services	/fr-be/acheter/services-volvo/financement-et-leasing	*
/fr-be/vente/services-supplementaires/volvo-financial-services/business-use	/fr-be/acheter/services-volvo/financement-et-leasing/business-use	*
/fr-be/vente/services-supplementaires/volvo-financial-services/private-use	/fr-be/acheter/services-volvo/financement-et-leasing/private-use	*
/fr-be/vente/services-supplementaires/volvo-financial-services/private-use/private-lease	/fr-be/acheter/services-volvo/financement-et-leasing/private-use/private-lease	*
/fr-be/vente/services-supplementaires/volvo-financial-services/private-use/volvo-car-advantage	/fr-be/acheter/services-volvo/financement-et-leasing/private-use/volvo-car-advantage	*
/fr-be/vente/services-supplementaires/volvo-financial-services/private-use/volvo-car-finance	/fr-be/acheter/services-volvo/financement-et-leasing/private-use/volvo-car-finance	*
/lu/vente/configurez-et-achetez/Dlbi-B2C-Offer-Request	/lu/acheter/votre-nouvelle-volvo/Dlbi-B2C-Offer-Request	*
/lu/vente/configurez-et-achetez/Dlbi-B2C-Test-Drive-Request	/lu/acheter/votre-nouvelle-volvo/Dlbi-B2C-Test-Drive-Request	*
/lu/vente/configurez-et-achetez/KMU-V90cc	/lu/acheter/votre-nouvelle-volvo/KMU-V90cc	*
/lu/vente/configurez-et-achetez/Newsletter	/lu/acheter/votre-nouvelle-volvo/Newsletter	*
/lu/vente/configurez-et-achetez/VBS-KMU-LU	/lu/acheter/votre-nouvelle-volvo/VBS-KMU-LU	*
/lu/vente/configurez-et-achetez/VBS-Offer-request-LU	/lu/acheter/votre-nouvelle-volvo/VBS-Offer-request-LU	*
/lu/vente/configurez-et-achetez/VBS-Testdrive-LU	/lu/acheter/votre-nouvelle-volvo/VBS-Testdrive-LU	*
/lu/vente/configurez-et-achetez/VBS-Testdrive-LU-with-Powersearch-TEST	/lu/acheter/votre-nouvelle-volvo/VBS-Testdrive-LU-with-Powersearch-TEST	*
/lu/vente/configurez-et-achetez/brochures-et-listes-de-prix	/lu/acheter/votre-nouvelle-volvo/brochures-et-listes-de-prix	*
/lu/vente/configurez-et-achetez/comparateur-volvo	/lu/acheter/votre-nouvelle-volvo/comparateur-de-modeles-volvo	*
/lu/vente/configurez-et-achetez/configurez-votre-volvo	/lu/acheter/votre-nouvelle-volvo/configurez-votre-volvo	*
/lu/vente/configurez-et-achetez/offres	/lu/acheter/votre-nouvelle-volvo/offres	*
/lu/vente/configurez-et-achetez/reservez-un-essai	/lu/acheter/votre-nouvelle-volvo/reservez-un-essai	*
/lu/vente/configurez-et-achetez/trouvez-votre-concessionnaire	/lu/acheter/votre-nouvelle-volvo/trouvez-votre-concessionnaire	*
/lu/vente/selection/private-lease	/lu/acheter/services-volvo/financement-et-leasing/private-use/private-lease	*
/lu/vente/selection/volvo-on-call	/lu/apres-vente/votre-volvo/volvo-on-call	*
/lu/vente/services-supplementaires/diplomat-military-expat	/lu/acheter/services-volvo/diplomat-military-expat	*
/lu/vente/services-supplementaires/volvo-financial-services	/lu/acheter/services-volvo/financement-et-leasing	*
/lu/vente/services-supplementaires/volvo-financial-services/private-volvo-car-finance	/lu/acheter/services-volvo/financement-et-leasing/private-volvo-car-finance	*
/de/verbrauchswerte	/de/footer/verbrauchswerte	*
/be/verdelers	/nl-be/kopen/uw-nieuwe-volvo/volvo-verdelers	*
/nl-be/verkoop/configureer-en-koop/Nieuwsbrief	/nl-be/kopen/uw-nieuwe-volvo/Nieuwsbrief	*
/nl-be/verkoop/configureer-en-koop/aanbiedingen	/nl-be/kopen/uw-nieuwe-volvo/aanbiedingen	*
/nl-be/verkoop/configureer-en-koop/aanbiedingen/particulieren/v60	/nl-be/kopen/uw-nieuwe-volvo/aanbiedingen/particulieren/v60	*
/nl-be/verkoop/configureer-en-koop/boek-een-testrit	/nl-be/kopen/uw-nieuwe-volvo/boek-een-testrit	*
/nl-be/verkoop/configureer-en-koop/brochures-en-prijslijsten	/nl-be/kopen/uw-nieuwe-volvo/brochures-en-prijslijsten	*
/nl-be/verkoop/configureer-en-koop/ebrochure-thank-you	/nl-be/kopen/uw-nieuwe-volvo/ebrochure-thank-you	*
/nl-be/verkoop/configureer-en-koop/vind-uw-verdeler	/nl-be/kopen/uw-nieuwe-volvo/vind-uw-verdeler	*
/nl-be/verkoop/configureer-en-koop/volvo-vergelijker	/nl-be/kopen/uw-nieuwe-volvo/vergelijk-volvo-modellen	*
/nl-be/verkoop/extra-diensten/volvo-car-insurance	/nl-be/kopen/volvo-diensten/omniumverzekeringen	*
/nl-be/verkoop/extra-diensten/volvo-financial-services	/nl-be/kopen/volvo-diensten/financiering-en-leasing	*
/nl-be/verkoop/extra-diensten/volvo-financial-services/business-use	/nl-be/kopen/volvo-diensten/financiering-en-leasing/business-use	*
/nl-be/verkoop/extra-diensten/volvo-financial-services/private-use	/nl-be/kopen/volvo-diensten/financiering-en-leasing/private-use	*
/nl-be/verkoop/extra-diensten/volvo-financial-services/private-use/private-lease	/nl-be/kopen/volvo-diensten/financiering-en-leasing/private-use/private-lease	*
/nl-be/verkoop/extra-diensten/volvo-financial-services/private-use/volvo-car-advantage	/nl-be/kopen/volvo-diensten/financiering-en-leasing/private-use/volvo-car-advantage	*
/nl-be/verkoop/extra-diensten/volvo-financial-services/private-use/volvo-car-finance	/nl-be/kopen/volvo-diensten/financiering-en-leasing/private-use/volvo-car-finance	*
/nl-be/verkoop/in-de-kijker/private-lease	/nl-be/kopen/volvo-diensten/financiering-en-leasing/private-use/private-lease	*
/nl-be/verkoop/in-de-kijker/v60-twin-engine	/nl-be/over-volvo/innovaties/drive-e/twin-engine	*
/nl-be/verkoop/in-de-kijker/volvo-on-call	/nl-be/naverkoop/uw-volvo/volvo-on-call	*
/nl/verkoopvoorwaarden	/nl/footer/verkoopvoorwaarden	*
/de/versicherung	/de/beratung-und-kauf/unsere-leistungen/schwedenversicherung	*
/nl/verzekeringspremie	/nl/ontdek/producten/insurance/bereken-premie	*
/se/vindruta	/se/AGA/Service/Service-och-Underhall/Vindruta	*
/be/vinter	/be	*
/nl/vision2020	/nl/over-volvo/onze-verhalen/vision-2020	*
/sk/vlastnictvo/preskumajte/newsletter	/sk/Forms/kmu	*
/ch/voc	/de-ch/Redirects/Volvo-On-Call	*
/lu/voc	/lu/pourquoi-volvo/innovation-humaine/avenir-de-la-conduite/connectivite/volvo-on-call	*
/se/voc	/se/agande/tjanster/volvo-on-call	*
/be/voc-nl	/nl-be/verkoop/in-de-kijker/volvo-on-call	*
/ch/vol	/de-ch/Redirects/vol	*
/za/volvo-car-insurance	/za/buy/finance-and-sales/volvo-car-insurance	*
/nl/volvo-en-hockey	/nl/Ontdek-Volvo/Onze-organisatie/Dit-is-Volvo-Cars/Volvo-en-hockey	*
/uk/volvo-live	/uk/about/humanmade/news	*
/pt/volvo-on-call	/pt/sobre-a-volvo/as-nossas-marcas-inovadoras/volvo-on-call	*
/se/volvo-on-call	/se/om-volvo/innovation/framtid/uppkopplad/volvo-on-call	*
/nl/volvo-private-lease	/nl/Lease-en-Financiering/Producten/Financieren/Volvo-Private-Lease	*
/cz/volvo-recall	/cz/pro-uzivatele/udrzba/volvo-recall	*
/dk/volvo-recall	/dk/own/service-og-reparation/volvo-recall	*
/gr/volvo-recall	/gr/Own/Services/Volvo-Recall	*
/intl/volvo-recall	/intl/own/owner-info/volvo-recall	*
/lu/volvo-recall	/lu/modeles/volvo-recall	*
/be/volvo-recall-fr	/fr-be/modeles/volvo-recall	*
/be/volvo-recall-nl	/nl-be/modellen/volvo-recall	*
/de-ch/volvo-rueckrufe	/de-ch/Beratung-und-Kauf/Zusatzinformationen/Volvo-Rueckrufe	*
/lu/volvo-selekt/semaine-volvo-selekt	/lu/volvo-selekt/	*
/nl-be/volvo-selekt/volvo-selekt-week	/nl-be/volvo-selekt	*
/dk/volvo-selekt  https://selekt.volvocars.dk/dk/volvo-selekt  *
/za/volvo-versatility-finance	/za/buy/finance-and-sales/volvo-versatility-finance	*
/uk/volvoaccidentassistance	/uk/own/maintenance/volvo-assistance	*
/at/volvoassistance	/at/beratung-und-kauf/mehr-erfahren/volvo-assistance	*
/ie/volvoassistance	/ie/own/enjoy/road-side-assistance	*
/uk/volvoassistance	/uk/own/maintenance/volvo-assistance	*
/uk/volvocarinsurance	/uk/buy/sales/volvo-car-insurance	*
/us/volvocarsforalex	/us/shopping-tools/additional-choices/events/volvo-cars-for-alex	*
/uk/volvocompare	/uk/buy/sales/car-comparison-tool	*
/at/volvodrive	/at/volvo/unsere-innovationen/drive-e	*
/be/volvofindsyou	/be	*
/de/volvoforum	/de/volvo/mehr-volvo/volvoforum	*
/de/volvoid	/de/Deutschland	*
/nl/volvoid-info	/nl/Ontdek-Volvo/Connectiviteit/Volvo-On-Call/Volvo-ID	*
/nl/volvolifepaint	/nl/over-volvo/onze-innovaties/volvo-life-paint	*
/at/volvooncall	/at/service-und-zubehoer/ihr-volvo/volvo-on-call	*
/be/volvooncall	/be	*
/fr-be/volvooncall	/fr-be/support/downloads/mobile-apps/volvo-on-call	*
/lu/volvooncall	/lu/pourquoi-volvo/innovation-humaine/avenir-de-la-conduite/connectivite/volvo-on-call	*
/nl-be/volvooncall	/nl-be/support/topics/volvo-on-call	*
/nl/volvooncall	/nl/Ontdek-Volvo/Innovaties/Toekomst-van-mobiliteit/Connectiviteit/Volvo-on-call	*
/no/volvooncall	/no/own/enjoy/volvo-on-call	*
/se/volvooncall	/se/agande/tjanster/volvo-on-call	*
/us/volvooncall	/us/own/connected-car/volvo-on-call	*
/be/volvooncall-nl	/nl-be/verkoop/in-de-kijker/volvo-on-call	*
/de/volvopro	/de/beratung-und-kauf/unsere-leistungen/servicevertraege	*
/de/volvoproanschlussgarantie	/de/zubehoer-und-services/zubehoer-und-services/anschlussgarantie	*
/de/volvoprofullservice	/de/beratung-und-kauf/unsere-leistungen/servicevertraege	*
/us/volvoreality	/us/shopping-tools/additional-choices/events/racing-the-sun	*
/pt/volvoremotesales	/pt/servicos/marca%C3%A7%C3%B5es/remote-sales	*
/be/volvostories	/be	*
/ch/volvoxc60	/de-ch/redirects/xc60-lagerpraemie	*
/de/vorpremiere	/de/beratung-und-kauf/mehr-erleben/Klubb90	*
/ch/vos	/de-ch/redirects/vos	*
/ch/vps	/de-ch/Redirects/Volvo-Personal-Service	*
/uk/vq	/uk/cars/business-sales/vq	*
/uk/vqmagazine	/uk/cars/business-sales/vq	*
/ch/vsp	/de-ch/Redirects/Volvo-Swiss-Premium	*
/ch/vsp-longlife	/de-ch/Redirects/Volvo-Swiss-Premium-Longlife	*
/nl/webshop	/nl/service/uw-volvo/accessoires#webshop	*
/nl/werkplaatsafspraak	/nl/Service-en-Accessoires/Onderhoud-en-reparatie/Service-by-Volvo/Afspraak-maken	*
/at/werksabholung	/at/beratung-und-kauf/angebote/werksabholung	*
/at/werksbesichtigung	/at/Beratung-und-Kauf/Kauf/Werksabholung	*
/ro-MD/wfsc%20forms/price_list	/ro-MD/Forms/or-ro	*
/be/wheelconfigurator	/be	*
/be/wielensets	/nl-be/accessoires/wielen-en-velgen	*
/at/winter	/at/service-und-zubehoer/ihr-volvo/zubehoer/winter-2018	*
/ch/winter	/de-ch/Redirects/Winter	*
/nl/winterbanden	/nl/service/uw-volvo/accessoires/wielensets	*
/be/wintercheck	/nl-be/naverkoop/uw-volvo/onderhoud-en-reparatie/seizoenscheck	*
/nl/wintercheck	/nl/l/winter/  *
/ch/winterdriving	/de-ch/redirects/winterdriving	*
/ch/winterquiz	/de-ch/ueber-volvo/ueber-uns/winterquiz	*
/be/winterwielen	/nl-be/accessoires/wielen-en-velgen/complete-winterwielen	*
/nl/winterwielen	/nl/Service-en-Accessoires/Onderhoud-en-reparatie/Volvo-Banden/Winterwielen	*
/be/winterwielenactie	/nl-be/accessoires/wielen-en-velgen/complete-winterwielen	*
/nl/wisserbladen	/nl/service/uw-volvo/accessoires	*
/de/wpicbvtest	/de/carebyvolvo	*
/at/xc40	/at/modelle/unsere-modelle/xc40	*
/ch/xc40	/de-ch/Redirects/XC40	*
/cz/xc40	/cz/vozy/modely/volvo-xc40	*
/jp/xc40	/jp/cars/new-models/xc40	*
/nl/xc40-360	/nl/modellen/model/xc40#360	*
/ch/xc40-electric	/de-ch/redirects/xc40-electric	*
/us/xc40-electric	/us/cars/xc40-pure-electric	*
/de/xc40-gewinnspiel	/de/modelle/neuwagen/xc40/xciteday/gewinnspiel	*
/de/xc40-pure-electric	/de/v/cars/xc40-electric	*
/se/xc40cbv	/se/care-by-volvo	*
/ch/xc40hybrid	/de-ch/redirects/xc40-hybrid	*
/uk/xc40offer	/uk/Cars/New-Models/XC40/Test-Drive	*
/nl/xc40pers	/nl/Modellen/Model/XC40/Persreacties	*
/nl/xc40privatelease	/nl/Lease-en-Financiering/Producten/Financieren/Volvo-Private-Lease/xc40privatelease	*
/nl/xc40proefrit	/nl/Modellen/Model/XC40/Proefrit	*
/de/xc40recharge	/de/Modelle/Neuwagen/XC40/Recharge/Plug-in-Hybrid	*
/ch/xc40rechargepureelectric	/de-ch/redirects/xc40-recharge-pure-electric	*
/ch/xc40te	/de-ch/redirects/xc40te	*
/at/xc60	/at/modelle/unsere-modelle/volvo-xc60	*
/ca/xc60	/en-ca/cars/new-models/xc60	*
/ch/xc60	/de-ch/Redirects/XC60	*
/cz/xc60	/cz/vozy/modely/volvo-xc60	*
/de/xc60	/de/v/cars/xc60-hybrid	*
/diplomat/xc60	/diplomat/cars/new-models/xc60	*
/en/xc60	/de/volvo/innovationen/elektromobilitaet/xc60	*
/fi/xc60	/fi/mallisto/mallit/xc60	*
/jp/xc60	/jp/cars/new-models/xc60	*
/nl/xc60	/nl-be/v/cars/xc60-hybrid	*
/se/xc60	/se/bilar/modeller/xc60	*
/at/xc60-awd	/at/beratung-und-kauf/angebote/angebote/awd-bonus	*
/at/xc60-awd-bonus	/at/beratung-und-kauf/angebote/angebote/awd-bonus	*
/uk/xc60business	/uk/cars/business-sales/xc60	*
/ch/xc60hybrid	/de-ch/redirects/xc60-hybrid	*
/uk/xc60loyalty	/uk/Cars/New-Models/XC60/XC60-Loyalty-Offer	*
/at/xc60neu	/at/modelle/unsere-modelle/volvo-xc60	*
/de/xc70	/de/modelle/neuwagen/xc70	*
/fi/xc70-classic	/fi/mallisto/mallit/xc70-classic	*
/at/xc90	/at/modelle/unsere-modelle/volvo-xc90	*
/ca/xc90	/en-ca/cars/new-models/all-new-xc90	*
/ch/xc90	/de-ch/Redirects/XC90	*
/cz/xc90	/cz/vozy/modely/volvo-xc90	*
/de/xc90	/de/v/cars/XC90-hybrid	*
/jp/xc90	/jp/cars/new-models/xc90	*
/se/xc90	/se/bilar/modeller/xc90	*
/uk/xc90	/uk/cars/new-models/xc90	*
/us/xc90	/us/cars/new-models/xc90	*
/zh-cn/xc90	/zh-cn/cars/new-models/all-new-xc90	*
/se/xc90info	/se/bilar/modeller/xc90	*
/uk/xc90loyalty	/uk/Cars/New-Models/XC90/XC90-Loyalty-Offer	*
/at/xc90newsletter	/at/footer/newsletter	*
/ch/xc90twinengine	/de-ch/Redirects/xc90te	*
/us/xcrange	/us/cars/new-models/suv	*
/ie/yourdata	/ie/Footer/GDPRPrivacyNotice	*
/uk/yourdata	/uk/Footer/Information-Notice/13	*
/nl/yourfulldaytestdrive	/nl/ontdek/samenstellen/proefrit-boeken	*
/si/zakaj-volvo/inovacije/povezljivost/intellisafe-assist	/si/zakaj-volvo/inovacije/varnost	*
/si/zakaj-volvo/inovacije/prihodnost-voznje/pogon	/si/Zakaj-Volvo/Inovacije/Electrification	*
/si/zakaj-volvo/inovacije/prihodnost-voznje/pogon/elektricni-avtomobil	/si/Zakaj-Volvo/Inovacije/Electrification/Pure-electric	*
/si/zakaj-volvo/inovacije/prihodnost-voznje/pogon/mild-hybrids	/si/Zakaj-Volvo/Inovacije/Electrification/Mild-hybrids	*
/si/zakaj-volvo/inovacije/prihodnost-voznje/pogon/plug-in-hybrids	/si/Zakaj-Volvo/Inovacije/Electrification/Plug-in-hybrids	*
/si/zakaj-volvo/inovacije/varnost/cars-safe-for-all	/si/Zakaj-Volvo/Inovacije/Varnost	*
/si/zakaj-volvo/inovacije/varnost/intellisafe-surround	/si/zakaj-volvo/inovacije/varnost/	*
/si/zakaj-volvo/inovacije/varnost/standardni-intellisafe	/si/zakaj-volvo/inovacije/varnost/	*
/nl/zakelijk-lease	/nl/Lease-en-Financiering/Producten/Zakelijk-lease	*
/rs/zasto-volvo/inovacije/bezbednost/cars-safe-for-all	/rs/Zasto-Volvo/Inovacije/Bezbednost	*
/rs/zasto-volvo/inovacije/bezbednost/intellisafe-standard	/rs/Zasto-Volvo/Inovacije/Bezbednost	*
/rs/zasto-volvo/inovacije/bezbednost/intellisafe-surround	/rs/Zasto-Volvo/Inovacije/Bezbednost	*
/rs/zasto-volvo/inovacije/buducnost-voznje/pogon	/rs/Zasto-Volvo/Inovacije/Electrification	*
/rs/zasto-volvo/inovacije/buducnost-voznje/pogon/blagi-hibridi	/rs/Zasto-Volvo/Inovacije/Electrification/Mild-hybrids	*
/rs/zasto-volvo/inovacije/buducnost-voznje/pogon/electric-cars	/rs/Zasto-Volvo/Inovacije/Electrification/Pure-electric	*
/rs/zasto-volvo/inovacije/buducnost-voznje/pogon/motori-sus	/rs/Zasto-Volvo/Inovacije/Electrification	*
/rs/zasto-volvo/inovacije/buducnost-voznje/pogon/plug-in-hibridi	/rs/Zasto-Volvo/Inovacije/Electrification/Plug-in-hybrids	*
/nl/zlatan	/nl/modellen/model/v90/made-by-sweden	*
/be/zomercheck	/nl-be/naverkoop/uw-volvo/onderhoud-en-reparatie/seizoenscheck	*
/nl/zomerwielen	/nl/Service-en-Accessoires/Onderhoud-en-reparatie/Volvo-Banden/Zomerwielen	*
/lv-lv/piedavajumi/piedavajumi  /lv-lv/l/Piedavajumi/Piedavajumi/   *
